id,season,team1,team2,result,target,team2_score,balls_30,team2_30_rn,team2_30_wk,team2_30_ach,balls_60,team2_60_rn,team2_60_wk,team2_60_ach,balls_90,team2_90_rn,team2_90_wk,team2_90_ach,dl_applied,winner,win_by_runs,win_by_wickets,team2_win,dls_5,dls_10,dls_15
1,2017,Sunrisers Hyderabad,Royal Challengers Bangalore,normal,208,172,90,48,0,124,60,98,2,74,30,139,5,33,0,Sunrisers Hyderabad,35,0,0,1,1,0
2,2017,Mumbai Indians,Rising Pune Supergiant,normal,185,187,90,43,1,144,60,93,1,94,30,139,2,48,0,Rising Pune Supergiant,0,7,1,1,1,1
3,2017,Gujarat Lions,Kolkata Knight Riders,normal,184,184,90,53,0,131,60,116,0,68,30,184,0,0,0,Kolkata Knight Riders,0,10,1,1,1,1
4,2017,Rising Pune Supergiant,Kings XI Punjab,normal,164,164,90,48,1,116,60,73,2,91,30,128,4,36,0,Kings XI Punjab,0,6,1,1,1,1
5,2017,Royal Challengers Bangalore,Delhi Daredevils,normal,158,142,90,37,1,105,60,79,3,63,30,113,6,29,0,Royal Challengers Bangalore,15,0,0,1,1,0
6,2017,Gujarat Lions,Sunrisers Hyderabad,normal,136,140,90,48,1,92,60,89,1,51,30,131,1,9,0,Sunrisers Hyderabad,0,9,1,1,1,1
7,2017,Kolkata Knight Riders,Mumbai Indians,normal,179,180,90,44,0,136,60,74,3,106,30,115,4,65,0,Mumbai Indians,0,4,1,1,0,0
8,2017,Royal Challengers Bangalore,Kings XI Punjab,normal,149,150,90,50,0,100,60,97,2,53,30,150,2,0,0,Kings XI Punjab,0,8,1,1,1,1
9,2017,Delhi Daredevils,Rising Pune Supergiant,normal,206,108,90,38,2,70,60,68,5,40,30,106,8,2,0,Delhi Daredevils,97,0,0,0,0,0
10,2017,Sunrisers Hyderabad,Mumbai Indians,normal,159,159,90,42,2,117,60,85,3,74,30,121,4,38,0,Mumbai Indians,0,4,1,1,1,1
11,2017,Kings XI Punjab,Kolkata Knight Riders,normal,171,171,90,60,0,111,60,116,2,55,30,157,2,14,0,Kolkata Knight Riders,0,8,1,1,1,1
12,2017,Royal Challengers Bangalore,Mumbai Indians,normal,143,145,90,18,4,127,60,48,5,97,30,91,5,54,0,Mumbai Indians,0,4,1,0,0,0
13,2017,Rising Pune Supergiant,Gujarat Lions,normal,172,172,90,46,0,126,60,96,1,76,30,133,3,39,0,Gujarat Lions,0,7,1,1,1,1
14,2017,Kolkata Knight Riders,Sunrisers Hyderabad,normal,173,155,90,39,0,116,60,59,2,96,30,113,5,42,0,Kolkata Knight Riders,17,0,0,1,0,0
15,2017,Delhi Daredevils,Kings XI Punjab,normal,189,137,90,33,3,104,60,64,4,73,30,103,6,34,0,Delhi Daredevils,51,0,0,0,0,0
16,2017,Gujarat Lions,Mumbai Indians,normal,177,177,90,47,1,130,60,89,2,88,30,132,3,45,0,Mumbai Indians,0,6,1,1,1,1
17,2017,Rising Pune Supergiant,Royal Challengers Bangalore,normal,162,134,90,39,1,95,60,67,2,67,30,92,4,42,0,Rising Pune Supergiant,27,0,0,1,1,0
18,2017,Delhi Daredevils,Kolkata Knight Riders,normal,169,169,90,34,3,135,60,88,3,81,30,135,4,34,0,Kolkata Knight Riders,0,4,1,0,1,1
19,2017,Sunrisers Hyderabad,Kings XI Punjab,normal,160,154,90,32,2,122,60,62,5,92,30,104,6,50,0,Sunrisers Hyderabad,5,0,0,0,0,0
20,2017,Royal Challengers Bangalore,Gujarat Lions,normal,214,192,90,48,2,144,60,103,3,89,30,139,5,53,0,Royal Challengers Bangalore,21,0,0,0,1,0
21,2017,Sunrisers Hyderabad,Delhi Daredevils,normal,192,176,90,47,1,129,60,87,3,89,30,127,4,49,0,Sunrisers Hyderabad,15,0,0,1,1,0
22,2017,Kings XI Punjab,Mumbai Indians,normal,199,199,90,68,0,131,60,123,1,76,30,191,2,8,0,Mumbai Indians,0,8,1,1,1,1
23,2017,Kolkata Knight Riders,Gujarat Lions,normal,188,188,90,62,1,126,60,99,3,89,30,146,5,42,0,Gujarat Lions,0,4,1,1,1,1
24,2017,Mumbai Indians,Delhi Daredevils,normal,143,128,90,21,4,107,60,57,6,71,30,91,6,37,0,Mumbai Indians,14,0,0,0,0,0
25,2017,Sunrisers Hyderabad,Rising Pune Supergiant,normal,177,179,90,37,1,142,60,83,1,96,30,115,3,64,0,Rising Pune Supergiant,0,6,1,1,1,1
26,2017,Kings XI Punjab,Gujarat Lions,normal,189,162,90,43,1,119,60,82,3,80,30,121,6,41,0,Kings XI Punjab,26,0,0,1,0,0
27,2017,Kolkata Knight Riders,Royal Challengers Bangalore,normal,132,49,90,28,4,21,60,49,10,0,30,49,10,0,0,Kolkata Knight Riders,82,0,0,0,0,0
28,2017,Rising Pune Supergiant,Mumbai Indians,normal,161,157,90,35,1,122,60,68,3,89,30,113,4,44,0,Rising Pune Supergiant,3,0,0,1,0,1
29,2017,Rising Pune Supergiant,Kolkata Knight Riders,normal,183,184,90,38,1,146,60,101,1,83,30,159,1,25,0,Kolkata Knight Riders,0,7,1,1,1,1
30,2017,Royal Challengers Bangalore,Gujarat Lions,normal,135,135,90,38,2,97,60,89,2,46,30,135,3,0,0,Gujarat Lions,0,7,1,1,1,1
31,2017,Delhi Daredevils,Kolkata Knight Riders,normal,161,161,90,36,1,125,60,101,1,60,30,140,3,21,0,Kolkata Knight Riders,0,7,1,1,1,1
32,2017,Sunrisers Hyderabad,Kings XI Punjab,normal,208,181,90,42,3,139,60,76,3,105,30,138,5,43,0,Sunrisers Hyderabad,26,0,0,0,0,0
33,2017,Rising Pune Supergiant,Royal Challengers Bangalore,normal,158,96,90,33,2,63,60,49,5,47,30,71,7,25,0,Rising Pune Supergiant,61,0,0,0,0,0
34,2017,Gujarat Lions,Mumbai Indians,tie,154,153,90,52,1,101,60,82,2,71,30,114,4,39,0,Mumbai Indians,0,0,1,1,1,1
35,2017,Delhi Daredevils,Kings XI Punjab,normal,68,68,90,39,0,29,60,68,0,0,30,68,0,0,0,Kings XI Punjab,0,10,1,1,1,1
36,2017,Sunrisers Hyderabad,Kolkata Knight Riders,normal,210,161,90,36,2,125,60,82,2,79,30,122,4,39,0,Sunrisers Hyderabad,48,0,0,0,0,0
37,2017,Royal Challengers Bangalore,Mumbai Indians,normal,163,165,90,47,1,118,60,74,3,91,30,114,5,51,0,Mumbai Indians,0,5,1,1,1,1
38,2017,Gujarat Lions,Rising Pune Supergiant,normal,162,167,90,37,3,130,60,67,4,100,30,102,4,65,0,Rising Pune Supergiant,0,5,1,0,0,0
39,2017,Sunrisers Hyderabad,Delhi Daredevils,normal,186,189,90,46,1,143,60,96,2,93,30,142,3,47,0,Delhi Daredevils,0,6,1,1,1,1
40,2017,Kolkata Knight Riders,Rising Pune Supergiant,normal,156,158,90,59,2,99,60,96,3,62,30,134,4,24,0,Rising Pune Supergiant,0,4,1,1,1,1
41,2017,Gujarat Lions,Delhi Daredevils,normal,209,214,90,58,1,156,60,113,1,101,30,182,3,32,0,Delhi Daredevils,0,7,1,1,1,1
42,2017,Kings XI Punjab,Royal Challengers Bangalore,normal,139,119,90,37,3,82,60,68,4,51,30,98,7,21,0,Kings XI Punjab,19,0,0,0,0,0
43,2017,Rising Pune Supergiant,Sunrisers Hyderabad,normal,149,136,90,33,2,103,60,74,2,62,30,101,4,35,0,Rising Pune Supergiant,12,0,0,0,1,1
44,2017,Mumbai Indians,Delhi Daredevils,normal,213,66,90,31,4,35,60,50,8,16,30,66,10,0,0,Mumbai Indians,146,0,0,0,0,0
45,2017,Royal Challengers Bangalore,Kolkata Knight Riders,normal,159,159,90,85,0,74,60,126,2,33,30,157,4,2,0,Kolkata Knight Riders,0,6,1,1,1,1
46,2017,Kings XI Punjab,Gujarat Lions,normal,190,192,90,49,0,143,60,103,1,89,30,148,2,44,0,Gujarat Lions,0,6,1,1,1,1
47,2017,Mumbai Indians,Sunrisers Hyderabad,normal,139,140,90,37,1,103,60,83,1,57,30,113,3,27,0,Sunrisers Hyderabad,0,7,1,1,1,1
48,2017,Kings XI Punjab,Kolkata Knight Riders,normal,168,153,90,49,1,104,60,79,3,74,30,118,3,35,0,Kings XI Punjab,14,0,0,1,1,1
49,2017,Gujarat Lions,Delhi Daredevils,normal,196,197,90,47,2,150,60,92,4,105,30,138,6,59,0,Delhi Daredevils,0,2,1,0,0,0
50,2017,Kings XI Punjab,Mumbai Indians,normal,231,223,90,52,0,171,60,108,2,115,30,148,4,75,0,Kings XI Punjab,7,0,0,1,1,0
51,2017,Delhi Daredevils,Rising Pune Supergiant,normal,169,161,90,41,2,120,60,78,3,83,30,117,3,44,0,Delhi Daredevils,7,0,0,0,1,1
52,2017,Gujarat Lions,Sunrisers Hyderabad,normal,155,158,90,33,2,125,60,82,2,76,30,127,2,31,0,Sunrisers Hyderabad,0,8,1,0,1,1
53,2017,Mumbai Indians,Kolkata Knight Riders,normal,174,164,90,49,2,115,60,92,5,72,30,131,6,33,0,Mumbai Indians,9,0,0,1,0,1
54,2017,Kings XI Punjab,Rising Pune Supergiant,normal,74,78,90,36,0,42,60,62,1,16,30,78,1,0,0,Rising Pune Supergiant,0,9,1,1,1,1
55,2017,Royal Challengers Bangalore,Delhi Daredevils,normal,162,151,90,40,1,111,60,76,2,75,30,104,4,47,0,Royal Challengers Bangalore,10,0,0,1,1,0
56,2017,Rising Pune Supergiant,Mumbai Indians,normal,163,142,90,41,1,101,60,71,4,71,30,103,7,39,0,Rising Pune Supergiant,20,0,0,1,0,0
58,2017,Kolkata Knight Riders,Mumbai Indians,normal,108,111,90,32,2,79,60,64,3,47,30,111,4,0,0,Mumbai Indians,0,6,1,1,1,1
59,2017,Mumbai Indians,Rising Pune Supergiant,normal,130,128,90,32,1,96,60,58,1,70,30,83,2,45,0,Mumbai Indians,1,0,0,1,1,1
60,2008,Kolkata Knight Riders,Royal Challengers Bangalore,normal,223,82,90,24,3,58,60,51,7,31,30,81,9,1,0,Kolkata Knight Riders,140,0,0,0,0,0
61,2008,Chennai Super Kings,Kings XI Punjab,normal,241,207,90,47,0,160,60,110,1,97,30,165,3,42,0,Chennai Super Kings,33,0,0,1,1,1
62,2008,Rajasthan Royals,Delhi Daredevils,normal,130,132,90,48,1,84,60,86,1,46,30,128,1,4,0,Delhi Daredevils,0,9,1,1,1,1
63,2008,Mumbai Indians,Royal Challengers Bangalore,normal,166,166,90,37,1,129,60,76,3,90,30,118,4,48,0,Royal Challengers Bangalore,0,5,1,1,1,1
64,2008,Deccan Chargers,Kolkata Knight Riders,normal,111,112,90,23,3,89,60,38,3,74,30,81,4,31,0,Kolkata Knight Riders,0,5,1,0,0,1
65,2008,Kings XI Punjab,Rajasthan Royals,normal,167,168,90,48,3,120,60,87,3,81,30,142,4,26,0,Rajasthan Royals,0,6,1,0,1,1
66,2008,Deccan Chargers,Delhi Daredevils,normal,143,143,90,37,1,106,60,95,1,48,30,143,1,0,0,Delhi Daredevils,0,9,1,1,1,1
67,2008,Chennai Super Kings,Mumbai Indians,normal,209,202,90,50,2,152,60,83,3,119,30,134,5,68,0,Chennai Super Kings,6,0,0,0,0,0
68,2008,Deccan Chargers,Rajasthan Royals,normal,215,217,90,57,1,160,60,114,2,103,30,159,3,58,0,Rajasthan Royals,0,3,1,1,1,1
69,2008,Kings XI Punjab,Mumbai Indians,normal,183,116,90,34,2,82,60,67,4,49,30,101,7,15,0,Kings XI Punjab,66,0,0,0,0,0
70,2008,Royal Challengers Bangalore,Rajasthan Royals,normal,136,138,90,39,2,99,60,73,2,65,30,121,2,17,0,Rajasthan Royals,0,7,1,1,1,1
71,2008,Kolkata Knight Riders,Chennai Super Kings,normal,148,152,90,35,0,117,60,77,1,75,30,121,1,31,0,Chennai Super Kings,0,9,1,1,1,1
72,2008,Mumbai Indians,Deccan Chargers,normal,155,155,90,47,0,108,60,130,0,25,30,155,0,0,0,Deccan Chargers,0,10,1,1,1,1
73,2008,Delhi Daredevils,Kings XI Punjab,normal,159,162,90,43,2,119,60,81,3,81,30,123,4,39,0,Kings XI Punjab,0,4,1,1,1,1
74,2008,Chennai Super Kings,Royal Challengers Bangalore,normal,179,165,90,32,1,133,60,93,1,72,30,132,3,33,0,Chennai Super Kings,13,0,0,0,1,1
75,2008,Kolkata Knight Riders,Mumbai Indians,normal,138,138,90,29,3,109,60,69,3,69,30,110,3,28,0,Mumbai Indians,0,7,1,0,1,1
76,2008,Delhi Daredevils,Royal Challengers Bangalore,normal,192,181,90,48,3,133,60,83,3,98,30,134,3,47,0,Delhi Daredevils,10,0,0,0,0,1
77,2008,Deccan Chargers,Kings XI Punjab,normal,165,167,90,37,0,130,60,77,2,90,30,129,3,38,0,Kings XI Punjab,0,7,1,1,1,1
78,2008,Rajasthan Royals,Kolkata Knight Riders,normal,197,151,90,44,2,107,60,78,3,73,30,128,5,23,0,Rajasthan Royals,45,0,0,0,0,0
79,2008,Chennai Super Kings,Delhi Daredevils,normal,170,172,90,54,0,118,60,106,0,66,30,142,2,30,0,Delhi Daredevils,0,8,1,1,1,1
80,2008,Deccan Chargers,Royal Challengers Bangalore,normal,166,171,90,36,1,135,60,61,2,110,30,106,3,65,0,Royal Challengers Bangalore,0,5,1,1,0,0
81,2008,Kings XI Punjab,Kolkata Knight Riders,normal,179,169,90,29,4,140,60,52,5,117,30,101,5,68,0,Kings XI Punjab,9,0,0,0,0,0
82,2008,Mumbai Indians,Delhi Daredevils,normal,163,133,90,29,2,104,60,81,3,52,30,114,5,19,0,Mumbai Indians,29,0,0,0,1,1
83,2008,Chennai Super Kings,Rajasthan Royals,normal,110,110,90,34,0,76,60,78,0,32,30,110,2,0,0,Rajasthan Royals,0,8,1,1,1,1
84,2008,Royal Challengers Bangalore,Kings XI Punjab,normal,127,127,90,44,1,83,60,81,2,46,30,109,4,18,0,Kings XI Punjab,0,6,1,1,1,1
85,2008,Chennai Super Kings,Deccan Chargers,normal,145,148,90,30,1,118,60,78,2,70,30,115,2,33,0,Deccan Chargers,0,7,1,1,1,1
86,2008,Rajasthan Royals,Mumbai Indians,normal,104,104,90,29,0,75,60,64,1,40,30,102,3,2,0,Mumbai Indians,0,7,1,1,1,1
87,2008,Delhi Daredevils,Chennai Super Kings,normal,188,188,90,42,0,146,60,98,2,90,30,142,4,46,0,Chennai Super Kings,0,4,1,1,1,1
88,2008,Kolkata Knight Riders,Royal Challengers Bangalore,normal,130,124,90,32,2,92,60,53,3,71,30,111,4,13,0,Kolkata Knight Riders,5,0,0,0,0,1
89,2008,Deccan Chargers,Rajasthan Royals,normal,141,141,90,33,0,108,60,81,0,60,30,129,1,12,0,Rajasthan Royals,0,8,1,1,1,1
90,2008,Royal Challengers Bangalore,Mumbai Indians,normal,123,126,90,36,0,90,60,79,0,47,30,117,1,9,0,Mumbai Indians,0,9,1,1,1,1
91,2008,Chennai Super Kings,Kings XI Punjab,normal,182,163,90,31,2,132,60,76,2,87,30,115,6,48,0,Chennai Super Kings,18,0,0,0,1,0
92,2008,Kolkata Knight Riders,Deccan Chargers,normal,205,181,90,41,2,140,60,74,4,107,30,125,6,56,0,Kolkata Knight Riders,23,0,0,0,0,0
93,2008,Delhi Daredevils,Rajasthan Royals,normal,157,159,90,15,2,144,60,80,2,79,30,120,4,39,0,Rajasthan Royals,0,3,1,0,1,1
94,2008,Royal Challengers Bangalore,Kings XI Punjab,normal,144,144,90,33,0,111,60,70,1,74,30,141,1,3,0,Kings XI Punjab,0,9,1,1,1,1
95,2008,Kolkata Knight Riders,Delhi Daredevils,normal,134,110,90,32,4,78,60,64,5,46,30,97,6,13,0,Kolkata Knight Riders,23,0,0,0,0,0
96,2008,Chennai Super Kings,Mumbai Indians,normal,157,158,90,57,0,101,60,107,1,51,30,158,1,0,0,Mumbai Indians,0,9,1,1,1,1
97,2008,Kings XI Punjab,Rajasthan Royals,normal,222,180,90,29,2,151,60,67,2,113,30,140,5,40,0,Kings XI Punjab,41,0,0,0,0,0
98,2008,Delhi Daredevils,Deccan Chargers,normal,195,182,90,61,1,121,60,84,3,98,30,128,4,54,0,Delhi Daredevils,12,0,0,1,0,0
99,2008,Kolkata Knight Riders,Mumbai Indians,normal,68,68,90,53,2,15,60,68,2,0,30,68,2,0,0,Mumbai Indians,0,8,1,1,1,1
101,2008,Rajasthan Royals,Royal Challengers Bangalore,normal,198,132,90,18,3,114,60,38,4,94,30,83,7,49,0,Rajasthan Royals,65,0,0,0,0,0
102,2008,Mumbai Indians,Deccan Chargers,normal,179,153,90,23,3,130,60,59,4,94,30,106,4,47,0,Mumbai Indians,25,0,0,0,0,0
104,2008,Royal Challengers Bangalore,Delhi Daredevils,normal,155,158,90,60,0,98,60,105,2,53,30,127,4,31,0,Delhi Daredevils,0,5,1,1,1,1
105,2008,Kolkata Knight Riders,Rajasthan Royals,normal,148,150,90,42,1,108,60,69,4,81,30,128,4,22,0,Rajasthan Royals,0,6,1,1,0,1
106,2008,Kings XI Punjab,Mumbai Indians,normal,190,188,90,56,1,132,60,90,2,98,30,144,3,44,0,Kings XI Punjab,1,0,0,1,1,1
107,2008,Royal Challengers Bangalore,Chennai Super Kings,normal,127,112,90,42,0,70,60,61,1,51,30,92,4,20,0,Royal Challengers Bangalore,14,0,0,1,1,1
108,2008,Deccan Chargers,Kings XI Punjab,normal,176,178,90,63,0,115,60,101,1,77,30,135,2,43,0,Kings XI Punjab,0,6,1,1,1,1
109,2008,Mumbai Indians,Delhi Daredevils,normal,177,179,90,50,2,129,60,88,2,91,30,130,5,49,0,Delhi Daredevils,0,5,1,1,1,1
110,2008,Rajasthan Royals,Chennai Super Kings,normal,212,201,90,55,1,146,60,99,2,102,30,157,3,44,0,Rajasthan Royals,10,0,0,1,1,1
111,2008,Royal Challengers Bangalore,Deccan Chargers,normal,157,153,90,31,1,122,60,63,2,90,30,112,2,41,0,Royal Challengers Bangalore,3,0,0,1,1,1
112,2008,Kings XI Punjab,Kolkata Knight Riders,normal,175,175,90,45,0,130,60,74,4,101,30,104,5,71,0,Kolkata Knight Riders,0,3,1,1,0,0
113,2008,Mumbai Indians,Rajasthan Royals,normal,146,146,90,32,1,114,60,67,3,79,30,90,5,56,0,Rajasthan Royals,0,5,1,1,1,0
114,2008,Deccan Chargers,Chennai Super Kings,normal,148,148,90,41,1,107,60,72,2,76,30,114,2,34,0,Chennai Super Kings,0,7,1,1,1,1
115,2008,Rajasthan Royals,Delhi Daredevils,normal,193,87,90,24,2,63,60,56,5,31,30,82,8,5,0,Rajasthan Royals,105,0,0,0,0,0
116,2008,Kings XI Punjab,Chennai Super Kings,normal,113,116,90,30,1,86,60,62,1,54,30,116,1,0,0,Chennai Super Kings,0,9,1,1,1,1
117,2008,Chennai Super Kings,Rajasthan Royals,normal,164,164,90,36,1,128,60,75,3,89,30,112,4,52,0,Rajasthan Royals,0,3,1,1,1,1
118,2009,Mumbai Indians,Chennai Super Kings,normal,166,146,90,33,2,113,60,70,3,76,30,108,5,38,0,Mumbai Indians,19,0,0,0,0,0
119,2009,Royal Challengers Bangalore,Rajasthan Royals,normal,134,58,90,13,2,45,60,32,5,26,30,58,9,0,0,Royal Challengers Bangalore,75,0,0,0,0,0
121,2009,Kolkata Knight Riders,Deccan Chargers,normal,102,104,90,35,2,69,60,69,2,35,30,104,2,0,0,Deccan Chargers,0,8,1,1,1,1
122,2009,Chennai Super Kings,Royal Challengers Bangalore,normal,180,87,90,40,1,47,60,56,5,31,30,85,9,2,0,Chennai Super Kings,92,0,0,1,0,0
124,2009,Deccan Chargers,Royal Challengers Bangalore,normal,185,160,90,25,2,135,60,57,3,103,30,109,4,51,0,Deccan Chargers,24,0,0,0,0,0
125,2009,Delhi Daredevils,Chennai Super Kings,normal,190,180,90,56,0,124,60,106,2,74,30,148,4,32,0,Delhi Daredevils,9,0,0,1,1,1
126,2009,Rajasthan Royals,Kolkata Knight Riders,tie,151,150,90,28,1,122,60,67,3,83,30,98,5,52,0,Rajasthan Royals,0,0,0,0,1,0
127,2009,Royal Challengers Bangalore,Kings XI Punjab,normal,169,173,90,39,0,134,60,80,1,93,30,109,2,64,0,Kings XI Punjab,0,7,1,1,1,1
128,2009,Deccan Chargers,Mumbai Indians,normal,169,156,90,42,1,114,60,84,1,72,30,108,4,48,0,Deccan Chargers,12,0,0,1,1,0
129,2009,Royal Challengers Bangalore,Delhi Daredevils,normal,150,150,90,39,1,111,60,64,2,86,30,99,3,51,0,Delhi Daredevils,0,6,1,1,1,1
130,2009,Kings XI Punjab,Rajasthan Royals,normal,140,112,90,27,4,85,60,48,6,64,30,82,6,30,0,Kings XI Punjab,27,0,0,0,0,0
131,2009,Chennai Super Kings,Deccan Chargers,normal,166,169,90,66,0,103,60,85,2,84,30,129,3,40,0,Deccan Chargers,0,6,1,1,1,1
132,2009,Mumbai Indians,Kolkata Knight Riders,normal,188,95,90,39,2,56,60,70,2,25,30,95,7,0,0,Mumbai Indians,92,0,0,0,0,0
133,2009,Delhi Daredevils,Rajasthan Royals,normal,144,147,90,31,2,116,60,60,3,87,30,96,5,51,0,Rajasthan Royals,0,5,1,0,0,0
134,2009,Kolkata Knight Riders,Royal Challengers Bangalore,normal,140,143,90,40,0,103,60,65,0,78,30,98,2,45,0,Royal Challengers Bangalore,0,5,1,1,1,1
135,2009,Kings XI Punjab,Mumbai Indians,normal,120,116,90,13,3,103,60,47,4,69,30,81,4,35,0,Kings XI Punjab,3,0,0,0,0,1
136,2009,Deccan Chargers,Delhi Daredevils,normal,149,150,90,35,2,115,60,70,3,80,30,101,3,49,0,Delhi Daredevils,0,6,1,0,1,1
137,2009,Chennai Super Kings,Rajasthan Royals,normal,165,126,90,28,1,98,60,61,3,65,30,98,5,28,0,Chennai Super Kings,38,0,0,0,0,0
138,2009,Mumbai Indians,Kolkata Knight Riders,normal,149,139,90,21,2,118,60,60,2,79,30,98,3,41,0,Mumbai Indians,9,0,0,0,1,1
139,2009,Royal Challengers Bangalore,Kings XI Punjab,normal,146,137,90,28,0,109,60,70,1,67,30,95,3,42,0,Royal Challengers Bangalore,8,0,0,1,1,1
140,2009,Deccan Chargers,Rajasthan Royals,normal,142,142,90,20,3,122,60,60,5,82,30,98,6,44,0,Rajasthan Royals,0,3,1,0,0,0
141,2009,Chennai Super Kings,Delhi Daredevils,normal,164,145,90,38,2,107,60,72,3,73,30,120,3,25,0,Chennai Super Kings,18,0,0,0,1,1
142,2009,Kolkata Knight Riders,Kings XI Punjab,normal,154,154,90,44,1,110,60,81,3,73,30,116,4,38,0,Kings XI Punjab,0,6,1,1,1,1
143,2009,Mumbai Indians,Royal Challengers Bangalore,normal,150,150,90,51,1,99,60,74,1,76,30,122,1,28,0,Royal Challengers Bangalore,0,9,1,1,1,1
144,2009,Chennai Super Kings,Deccan Chargers,normal,179,100,90,34,3,66,60,79,5,21,30,100,10,0,0,Chennai Super Kings,78,0,0,0,0,0
145,2009,Rajasthan Royals,Kings XI Punjab,normal,212,133,90,25,3,108,60,53,5,80,30,96,6,37,0,Rajasthan Royals,78,0,0,0,0,0
146,2009,Kolkata Knight Riders,Delhi Daredevils,normal,155,157,90,49,0,108,60,76,1,81,30,114,1,43,0,Delhi Daredevils,0,9,1,1,1,1
147,2009,Deccan Chargers,Mumbai Indians,normal,146,126,90,27,2,99,60,71,3,55,30,100,4,26,0,Deccan Chargers,19,0,0,0,1,1
148,2009,Royal Challengers Bangalore,Rajasthan Royals,normal,106,107,90,25,0,82,60,62,2,45,30,107,3,0,0,Rajasthan Royals,0,7,1,1,1,1
150,2009,Mumbai Indians,Delhi Daredevils,normal,117,118,90,33,0,85,60,52,2,66,30,74,2,44,0,Delhi Daredevils,0,7,1,1,1,1
151,2009,Deccan Chargers,Kings XI Punjab,normal,169,169,90,42,2,127,60,86,4,83,30,119,5,50,0,Kings XI Punjab,0,3,1,0,1,1
152,2009,Rajasthan Royals,Chennai Super Kings,normal,141,141,90,25,1,116,60,67,2,74,30,97,2,44,0,Chennai Super Kings,0,7,1,0,1,1
153,2009,Mumbai Indians,Royal Challengers Bangalore,normal,158,141,90,31,2,110,60,58,4,83,30,100,6,41,0,Mumbai Indians,16,0,0,0,0,0
154,2009,Kolkata Knight Riders,Delhi Daredevils,normal,124,125,90,45,0,80,60,72,3,53,30,100,3,25,0,Delhi Daredevils,0,7,1,1,1,1
155,2009,Deccan Chargers,Rajasthan Royals,normal,167,113,90,25,2,88,60,59,3,54,30,95,6,18,0,Deccan Chargers,53,0,0,0,0,0
156,2009,Kolkata Knight Riders,Royal Challengers Bangalore,normal,174,176,90,36,0,140,60,70,2,106,30,119,3,57,0,Royal Challengers Bangalore,0,6,1,1,1,1
157,2009,Kings XI Punjab,Mumbai Indians,normal,120,122,90,35,1,87,60,74,2,48,30,113,2,9,0,Mumbai Indians,0,8,1,1,1,1
158,2009,Delhi Daredevils,Deccan Chargers,normal,174,161,90,40,2,121,60,83,2,78,30,134,3,27,0,Delhi Daredevils,12,0,0,0,1,1
159,2009,Chennai Super Kings,Royal Challengers Bangalore,normal,130,132,90,30,3,102,60,57,3,75,30,91,4,41,0,Royal Challengers Bangalore,0,2,1,0,1,1
160,2009,Rajasthan Royals,Mumbai Indians,normal,146,143,90,23,2,120,60,54,3,89,30,98,5,45,0,Rajasthan Royals,2,0,0,0,0,0
161,2009,Delhi Daredevils,Kings XI Punjab,normal,121,123,90,35,2,88,60,50,3,73,30,86,3,37,0,Kings XI Punjab,0,6,1,1,0,1
162,2009,Mumbai Indians,Chennai Super Kings,normal,148,151,90,34,2,117,60,56,2,95,30,102,3,49,0,Chennai Super Kings,0,7,1,0,0,1
163,2009,Kolkata Knight Riders,Deccan Chargers,normal,161,166,90,41,0,125,60,71,1,95,30,105,2,61,0,Deccan Chargers,0,6,1,1,1,1
164,2009,Kings XI Punjab,Deccan Chargers,normal,135,133,90,40,2,93,60,65,2,68,30,86,5,47,0,Kings XI Punjab,1,0,0,1,1,0
165,2009,Delhi Daredevils,Rajasthan Royals,normal,151,136,90,19,2,117,60,60,3,76,30,93,5,43,0,Delhi Daredevils,14,0,0,0,0,0
166,2009,Chennai Super Kings,Kolkata Knight Riders,normal,189,189,90,34,1,155,60,83,1,106,30,131,2,58,0,Kolkata Knight Riders,0,7,1,0,1,1
167,2009,Delhi Daredevils,Royal Challengers Bangalore,normal,135,135,90,19,1,116,60,54,1,81,30,102,3,33,0,Royal Challengers Bangalore,0,7,1,0,1,1
168,2009,Rajasthan Royals,Kolkata Knight Riders,normal,102,102,90,21,3,81,60,38,5,64,30,65,6,37,0,Kolkata Knight Riders,0,4,1,0,0,0
169,2009,Chennai Super Kings,Kings XI Punjab,normal,117,92,90,26,1,66,60,42,2,50,30,59,4,33,0,Chennai Super Kings,24,0,0,1,0,0
170,2009,Mumbai Indians,Delhi Daredevils,normal,166,166,90,46,1,120,60,93,1,73,30,146,4,20,0,Delhi Daredevils,0,4,1,1,1,1
171,2009,Royal Challengers Bangalore,Deccan Chargers,normal,171,158,90,45,0,113,60,85,1,73,30,119,3,39,0,Royal Challengers Bangalore,12,0,0,1,1,1
172,2009,Delhi Daredevils,Deccan Chargers,normal,154,154,90,59,1,95,60,102,3,52,30,146,4,8,0,Deccan Chargers,0,6,1,1,1,1
173,2009,Chennai Super Kings,Royal Challengers Bangalore,normal,147,149,90,49,2,100,60,82,2,67,30,110,3,39,0,Royal Challengers Bangalore,0,6,1,1,1,1
174,2009,Deccan Chargers,Royal Challengers Bangalore,normal,144,137,90,33,1,104,60,69,3,68,30,103,6,34,0,Deccan Chargers,6,0,0,1,1,0
175,2010,Kolkata Knight Riders,Deccan Chargers,normal,162,150,90,56,0,94,60,88,1,62,30,122,4,28,0,Kolkata Knight Riders,11,0,0,1,1,1
176,2010,Mumbai Indians,Rajasthan Royals,normal,213,208,90,38,1,170,60,69,4,139,30,143,4,65,0,Mumbai Indians,4,0,0,0,0,1
177,2010,Kings XI Punjab,Delhi Daredevils,normal,143,146,90,30,2,116,60,61,3,85,30,105,4,41,0,Delhi Daredevils,0,5,1,0,0,1
178,2010,Royal Challengers Bangalore,Kolkata Knight Riders,normal,136,136,90,52,0,84,60,85,0,51,30,116,2,20,0,Kolkata Knight Riders,0,7,1,1,1,1
179,2010,Deccan Chargers,Chennai Super Kings,normal,191,159,90,31,3,128,60,70,5,89,30,108,6,51,0,Deccan Chargers,31,0,0,0,0,0
180,2010,Rajasthan Royals,Delhi Daredevils,normal,142,142,90,47,2,95,60,99,3,43,30,131,4,11,0,Delhi Daredevils,0,6,1,1,1,1
181,2010,Kings XI Punjab,Royal Challengers Bangalore,normal,204,204,90,43,0,161,60,89,1,115,30,149,2,55,0,Royal Challengers Bangalore,0,8,1,1,1,1
182,2010,Chennai Super Kings,Kolkata Knight Riders,normal,165,109,90,34,3,75,60,67,5,42,30,90,9,19,0,Chennai Super Kings,55,0,0,0,0,0
183,2010,Mumbai Indians,Delhi Daredevils,normal,219,120,90,49,1,71,60,84,5,36,30,119,8,1,0,Mumbai Indians,98,0,0,1,0,0
184,2010,Rajasthan Royals,Royal Challengers Bangalore,normal,93,93,90,52,0,41,60,90,0,3,30,93,0,0,0,Royal Challengers Bangalore,0,10,1,1,1,1
185,2010,Delhi Daredevils,Chennai Super Kings,normal,186,190,90,50,1,140,60,102,2,88,30,153,3,37,0,Chennai Super Kings,0,5,1,1,1,1
186,2010,Deccan Chargers,Kings XI Punjab,normal,171,164,90,22,3,142,60,57,4,107,30,98,6,66,0,Deccan Chargers,6,0,0,0,0,0
187,2010,Rajasthan Royals,Kolkata Knight Riders,normal,169,134,90,37,1,97,60,65,1,69,30,99,3,35,0,Rajasthan Royals,34,0,0,1,1,0
188,2010,Mumbai Indians,Royal Challengers Bangalore,normal,152,155,90,40,0,115,60,85,1,70,30,117,2,38,0,Royal Challengers Bangalore,0,7,1,1,1,1
189,2010,Deccan Chargers,Delhi Daredevils,normal,172,161,90,41,1,120,60,85,1,76,30,116,4,45,0,Deccan Chargers,10,0,0,1,1,1
190,2010,Kings XI Punjab,Chennai Super Kings,tie,137,136,90,34,0,102,60,73,1,63,30,109,4,27,0,Kings XI Punjab,0,0,0,1,1,1
191,2010,Kolkata Knight Riders,Mumbai Indians,normal,156,156,90,51,0,105,60,76,1,80,30,122,2,34,0,Mumbai Indians,0,7,1,1,1,1
192,2010,Royal Challengers Bangalore,Chennai Super Kings,normal,172,135,90,22,1,113,60,61,3,74,30,95,5,40,0,Royal Challengers Bangalore,36,0,0,0,0,0
193,2010,Rajasthan Royals,Kings XI Punjab,normal,184,152,90,59,1,93,60,102,2,50,30,127,6,25,0,Rajasthan Royals,31,0,0,1,1,0
194,2010,Chennai Super Kings,Mumbai Indians,normal,181,181,90,50,0,131,60,98,2,83,30,133,3,48,0,Mumbai Indians,0,5,1,1,1,1
195,2010,Deccan Chargers,Rajasthan Royals,normal,149,151,90,51,0,100,60,95,1,56,30,139,2,12,0,Rajasthan Royals,0,8,1,1,1,1
196,2010,Kolkata Knight Riders,Kings XI Punjab,normal,184,144,90,31,1,113,60,74,3,70,30,102,5,42,0,Kolkata Knight Riders,39,0,0,0,0,0
197,2010,Delhi Daredevils,Royal Challengers Bangalore,normal,184,166,90,37,0,129,60,78,1,88,30,121,5,45,0,Delhi Daredevils,17,0,0,1,1,0
198,2010,Rajasthan Royals,Chennai Super Kings,normal,178,160,90,50,1,110,60,80,3,80,30,119,3,41,0,Rajasthan Royals,17,0,0,1,1,1
199,2010,Mumbai Indians,Deccan Chargers,normal,173,131,90,48,2,83,60,78,4,53,30,122,7,9,0,Mumbai Indians,41,0,0,1,0,0
200,2010,Delhi Daredevils,Kolkata Knight Riders,normal,178,137,90,32,3,105,60,55,4,82,30,98,5,39,0,Delhi Daredevils,40,0,0,0,0,0
201,2010,Kings XI Punjab,Mumbai Indians,normal,164,164,90,37,0,127,60,82,2,82,30,118,3,46,0,Mumbai Indians,0,4,1,1,1,1
202,2010,Royal Challengers Bangalore,Chennai Super Kings,normal,162,162,90,47,0,115,60,89,1,73,30,125,2,37,0,Chennai Super Kings,0,5,1,1,1,1
203,2010,Delhi Daredevils,Rajasthan Royals,normal,189,121,90,33,4,88,60,69,5,52,30,107,8,14,0,Delhi Daredevils,67,0,0,0,0,0
204,2010,Kolkata Knight Riders,Deccan Chargers,normal,182,157,90,46,1,111,60,87,2,70,30,125,3,32,0,Kolkata Knight Riders,24,0,0,1,1,1
205,2010,Kings XI Punjab,Royal Challengers Bangalore,normal,182,184,90,40,1,144,60,77,2,107,30,122,2,62,0,Royal Challengers Bangalore,0,6,1,1,1,1
206,2010,Chennai Super Kings,Rajasthan Royals,normal,247,223,90,47,0,176,60,105,2,118,30,175,2,48,0,Chennai Super Kings,23,0,0,1,1,1
207,2010,Mumbai Indians,Deccan Chargers,normal,179,115,90,36,1,79,60,68,3,47,30,98,6,17,0,Mumbai Indians,63,0,0,1,0,0
208,2010,Kolkata Knight Riders,Kings XI Punjab,normal,201,204,90,52,1,152,60,107,1,97,30,156,2,48,0,Kings XI Punjab,0,8,1,1,1,1
209,2010,Delhi Daredevils,Royal Challengers Bangalore,normal,185,147,90,36,1,111,60,56,2,91,30,111,4,36,0,Delhi Daredevils,37,0,0,1,0,0
210,2010,Rajasthan Royals,Deccan Chargers,normal,160,157,90,48,2,109,60,86,2,71,30,118,4,39,0,Rajasthan Royals,2,0,0,1,1,1
211,2010,Chennai Super Kings,Mumbai Indians,normal,166,141,90,38,0,103,60,67,2,74,30,92,7,49,0,Chennai Super Kings,24,0,0,1,1,0
212,2010,Kings XI Punjab,Rajasthan Royals,normal,154,157,90,65,0,92,60,111,1,46,30,157,1,0,0,Rajasthan Royals,0,9,1,1,1,1
213,2010,Kolkata Knight Riders,Delhi Daredevils,normal,182,167,90,39,1,128,60,91,1,76,30,135,4,32,0,Kolkata Knight Riders,14,0,0,1,1,1
214,2010,Royal Challengers Bangalore,Deccan Chargers,normal,185,186,90,30,1,156,60,80,1,106,30,125,3,61,0,Deccan Chargers,0,7,1,0,1,1
215,2010,Mumbai Indians,Kings XI Punjab,normal,155,158,90,46,1,112,60,87,1,71,30,116,2,42,0,Kings XI Punjab,0,6,1,1,1,1
216,2010,Chennai Super Kings,Deccan Chargers,normal,139,139,90,35,2,104,60,56,2,83,30,102,3,37,0,Deccan Chargers,0,6,1,1,1,1
217,2010,Kolkata Knight Riders,Royal Challengers Bangalore,normal,161,162,90,33,1,129,60,76,1,86,30,120,3,42,0,Royal Challengers Bangalore,0,7,1,1,1,1
218,2010,Delhi Daredevils,Kings XI Punjab,normal,112,112,90,32,0,80,60,59,1,53,30,88,2,24,0,Kings XI Punjab,0,7,1,1,1,1
219,2010,Mumbai Indians,Rajasthan Royals,normal,175,137,90,20,3,117,60,60,4,77,30,89,7,48,0,Mumbai Indians,37,0,0,0,0,0
220,2010,Deccan Chargers,Royal Challengers Bangalore,normal,152,138,90,32,1,106,60,72,1,66,30,102,4,36,0,Deccan Chargers,13,0,0,1,1,1
221,2010,Mumbai Indians,Delhi Daredevils,normal,184,144,90,55,1,89,60,87,4,57,30,108,6,36,0,Mumbai Indians,39,0,0,1,0,0
222,2010,Kolkata Knight Riders,Chennai Super Kings,normal,140,143,90,60,1,83,60,103,1,40,30,143,1,0,0,Chennai Super Kings,0,9,1,1,1,1
223,2010,Rajasthan Royals,Royal Challengers Bangalore,normal,131,132,90,42,2,90,60,91,2,41,30,124,5,8,0,Royal Challengers Bangalore,0,5,1,1,1,1
224,2010,Chennai Super Kings,Delhi Daredevils,normal,113,113,90,26,3,87,60,56,4,57,30,80,4,33,0,Delhi Daredevils,0,6,1,0,0,1
225,2010,Kings XI Punjab,Deccan Chargers,normal,175,178,90,37,1,141,60,82,2,96,30,131,4,47,0,Deccan Chargers,0,5,1,1,1,1
226,2010,Mumbai Indians,Royal Challengers Bangalore,normal,192,134,90,30,1,104,60,64,3,70,30,98,6,36,0,Mumbai Indians,57,0,0,0,0,0
227,2010,Rajasthan Royals,Kolkata Knight Riders,normal,133,133,90,38,2,95,60,69,2,64,30,118,2,15,0,Kolkata Knight Riders,0,8,1,1,1,1
228,2010,Kings XI Punjab,Chennai Super Kings,normal,193,195,90,37,2,158,60,94,3,101,30,130,3,65,0,Chennai Super Kings,0,6,1,0,1,1
229,2010,Deccan Chargers,Delhi Daredevils,normal,146,134,90,37,3,97,60,59,4,75,30,86,6,48,0,Deccan Chargers,11,0,0,0,0,0
230,2010,Mumbai Indians,Kolkata Knight Riders,normal,134,135,90,41,0,94,60,72,0,63,30,107,1,28,0,Kolkata Knight Riders,0,9,1,1,1,1
231,2010,Mumbai Indians,Royal Challengers Bangalore,normal,185,149,90,41,1,108,60,83,4,66,30,118,7,31,0,Mumbai Indians,35,0,0,1,0,0
232,2010,Chennai Super Kings,Deccan Chargers,normal,143,104,90,19,0,85,60,43,3,61,30,81,5,23,0,Chennai Super Kings,38,0,0,0,0,0
233,2010,Deccan Chargers,Royal Challengers Bangalore,normal,83,86,90,26,0,60,60,53,1,33,30,86,1,0,0,Royal Challengers Bangalore,0,9,1,1,1,1
234,2010,Chennai Super Kings,Mumbai Indians,normal,169,146,90,21,1,125,60,58,1,88,30,101,5,45,0,Chennai Super Kings,22,0,0,0,0,0
235,2011,Chennai Super Kings,Kolkata Knight Riders,normal,154,151,90,44,0,107,60,76,1,75,30,111,2,40,0,Chennai Super Kings,2,0,0,1,1,1
236,2011,Deccan Chargers,Rajasthan Royals,normal,138,141,90,29,0,112,60,60,1,81,30,93,2,48,0,Rajasthan Royals,0,8,1,1,1,1
237,2011,Kochi Tuskers Kerala,Royal Challengers Bangalore,normal,162,162,90,44,1,118,60,85,3,77,30,118,3,44,0,Royal Challengers Bangalore,0,6,1,1,1,1
238,2011,Delhi Daredevils,Mumbai Indians,normal,96,99,90,22,1,77,60,48,2,51,30,85,2,14,0,Mumbai Indians,0,8,1,1,1,1
239,2011,Kings XI Punjab,Pune Warriors,normal,113,113,90,32,1,81,60,74,3,39,30,113,3,0,0,Pune Warriors,0,7,1,1,1,1
240,2011,Kolkata Knight Riders,Deccan Chargers,normal,164,154,90,23,2,131,60,62,3,92,30,101,5,53,0,Kolkata Knight Riders,9,0,0,0,0,0
241,2011,Delhi Daredevils,Rajasthan Royals,normal,152,152,90,43,1,109,60,86,2,66,30,121,3,31,0,Rajasthan Royals,0,6,1,1,1,1
242,2011,Royal Challengers Bangalore,Mumbai Indians,normal,141,143,90,33,1,110,60,78,1,65,30,116,1,27,0,Mumbai Indians,0,9,1,1,1,1
243,2011,Chennai Super Kings,Kings XI Punjab,normal,189,193,90,49,0,144,60,99,1,94,30,138,4,55,0,Kings XI Punjab,0,6,1,1,1,1
244,2011,Kochi Tuskers Kerala,Pune Warriors,normal,149,151,90,37,1,114,60,61,3,90,30,115,5,36,0,Pune Warriors,0,4,1,1,0,1
245,2011,Deccan Chargers,Royal Challengers Bangalore,normal,176,142,90,27,3,115,60,53,4,89,30,92,5,50,0,Deccan Chargers,33,0,0,0,0,0
246,2011,Rajasthan Royals,Kolkata Knight Riders,normal,160,160,90,44,1,116,60,90,1,70,30,130,1,30,0,Kolkata Knight Riders,0,9,1,1,1,1
247,2011,Mumbai Indians,Kochi Tuskers Kerala,normal,183,184,90,32,0,152,60,84,0,100,30,134,1,50,0,Kochi Tuskers Kerala,0,8,1,1,1,1
248,2011,Chennai Super Kings,Royal Challengers Bangalore,normal,184,162,90,31,3,131,60,67,3,95,30,112,5,50,0,Chennai Super Kings,21,0,0,0,0,0
249,2011,Deccan Chargers,Kings XI Punjab,normal,166,166,90,59,0,107,60,104,0,62,30,139,1,27,0,Kings XI Punjab,0,8,1,1,1,1
250,2011,Pune Warriors,Delhi Daredevils,normal,188,190,90,52,0,138,60,98,2,92,30,128,5,62,0,Delhi Daredevils,0,3,1,1,1,0
251,2011,Rajasthan Royals,Kolkata Knight Riders,normal,82,85,90,23,1,62,60,45,2,40,30,85,2,0,0,Kolkata Knight Riders,0,8,1,1,1,1
253,2011,Deccan Chargers,Delhi Daredevils,normal,169,152,90,33,2,119,60,78,3,74,30,107,5,45,0,Deccan Chargers,16,0,0,0,1,0
254,2011,Pune Warriors,Mumbai Indians,normal,119,124,90,27,1,97,60,63,1,61,30,89,3,35,0,Mumbai Indians,0,7,1,1,1,1
255,2011,Kochi Tuskers Kerala,Kolkata Knight Riders,normal,133,126,90,28,2,98,60,59,3,67,30,86,5,40,0,Kochi Tuskers Kerala,6,0,0,0,1,0
256,2011,Kings XI Punjab,Rajasthan Royals,normal,196,147,90,38,2,109,60,61,4,86,30,113,5,34,0,Kings XI Punjab,48,0,0,0,0,0
257,2011,Mumbai Indians,Chennai Super Kings,normal,165,156,90,38,2,118,60,84,2,72,30,119,4,37,0,Mumbai Indians,8,0,0,0,1,1
258,2011,Kolkata Knight Riders,Royal Challengers Bangalore,normal,172,175,90,46,0,129,60,92,0,83,30,152,1,23,0,Royal Challengers Bangalore,0,9,1,1,1,1
259,2011,Delhi Daredevils,Kings XI Punjab,normal,232,202,90,34,1,168,60,96,1,106,30,147,3,55,0,Delhi Daredevils,29,0,0,0,1,0
260,2011,Mumbai Indians,Deccan Chargers,normal,173,135,90,39,1,96,60,72,4,63,30,100,6,35,0,Mumbai Indians,37,0,0,1,0,0
261,2011,Kochi Tuskers Kerala,Rajasthan Royals,normal,110,111,90,33,0,78,60,68,0,43,30,111,2,0,0,Rajasthan Royals,0,8,1,1,1,1
262,2011,Chennai Super Kings,Pune Warriors,normal,143,117,90,40,3,77,60,58,4,59,30,93,5,24,0,Chennai Super Kings,25,0,0,0,0,0
263,2011,Delhi Daredevils,Royal Challengers Bangalore,normal,161,161,90,62,1,99,60,97,4,64,30,117,5,44,0,Royal Challengers Bangalore,0,3,1,1,1,1
264,2011,Pune Warriors,Chennai Super Kings,normal,142,145,90,19,1,126,60,65,1,80,30,104,2,41,0,Chennai Super Kings,0,8,1,0,1,1
265,2011,Deccan Chargers,Kochi Tuskers Kerala,normal,130,74,90,23,6,51,60,45,6,29,30,73,7,1,0,Deccan Chargers,55,0,0,0,0,0
266,2011,Kolkata Knight Riders,Delhi Daredevils,normal,149,131,90,34,1,97,60,60,2,71,30,86,6,45,0,Kolkata Knight Riders,17,0,0,1,1,0
267,2011,Mumbai Indians,Rajasthan Royals,normal,95,95,90,17,1,78,60,46,1,49,30,73,2,22,0,Rajasthan Royals,0,7,1,0,1,1
268,2011,Royal Challengers Bangalore,Pune Warriors,normal,182,155,90,35,0,120,60,63,1,92,30,108,3,47,0,Royal Challengers Bangalore,26,0,0,1,0,0
269,2011,Delhi Daredevils,Kochi Tuskers Kerala,normal,158,119,90,29,3,90,60,51,4,68,30,92,5,27,0,Delhi Daredevils,38,0,0,0,0,0
270,2011,Kings XI Punjab,Kolkata Knight Riders,normal,120,120,90,40,2,80,60,71,2,49,30,102,2,18,0,Kolkata Knight Riders,0,8,1,1,1,1
271,2011,Pune Warriors,Rajasthan Royals,normal,144,144,90,29,1,115,60,59,2,85,30,92,4,52,0,Rajasthan Royals,0,6,1,1,1,0
272,2011,Chennai Super Kings,Deccan Chargers,normal,166,146,90,57,0,89,60,88,1,58,30,118,3,28,0,Chennai Super Kings,19,0,0,1,1,1
273,2011,Mumbai Indians,Kings XI Punjab,normal,160,136,90,18,1,118,60,62,1,74,30,101,4,35,0,Mumbai Indians,23,0,0,0,1,0
274,2011,Delhi Daredevils,Kochi Tuskers Kerala,normal,141,141,90,61,0,80,60,89,3,52,30,141,3,0,0,Kochi Tuskers Kerala,0,7,1,1,1,1
275,2011,Kolkata Knight Riders,Deccan Chargers,normal,170,149,90,38,0,111,60,68,2,81,30,108,4,41,0,Kolkata Knight Riders,20,0,0,1,1,0
276,2011,Rajasthan Royals,Chennai Super Kings,normal,148,149,90,39,1,110,60,73,1,76,30,118,1,31,0,Chennai Super Kings,0,8,1,1,1,1
277,2011,Mumbai Indians,Pune Warriors,normal,161,139,90,27,2,112,60,48,3,91,30,90,4,49,0,Mumbai Indians,21,0,0,0,0,0
278,2011,Kochi Tuskers Kerala,Kolkata Knight Riders,normal,157,139,90,40,0,99,60,69,0,70,30,100,3,39,0,Kochi Tuskers Kerala,17,0,0,1,1,0
279,2011,Deccan Chargers,Delhi Daredevils,normal,176,179,90,24,2,155,60,85,3,94,30,149,4,30,0,Delhi Daredevils,0,4,1,0,1,1
280,2011,Royal Challengers Bangalore,Kings XI Punjab,normal,206,120,90,33,3,87,60,62,6,58,30,89,7,31,0,Royal Challengers Bangalore,85,0,0,0,0,0
282,2011,Mumbai Indians,Delhi Daredevils,normal,179,146,90,13,4,133,60,56,4,90,30,99,5,47,0,Mumbai Indians,32,0,0,0,0,0
283,2011,Kochi Tuskers Kerala,Royal Challengers Bangalore,normal,126,128,90,72,1,56,60,109,1,19,30,128,1,0,0,Royal Challengers Bangalore,0,9,1,1,1,1
284,2011,Kings XI Punjab,Pune Warriors,normal,120,120,90,32,1,88,60,69,2,51,30,114,3,6,0,Pune Warriors,0,5,1,1,1,1
285,2011,Chennai Super Kings,Rajasthan Royals,normal,197,133,90,38,1,95,60,70,4,63,30,114,5,19,0,Chennai Super Kings,63,0,0,1,0,0
286,2011,Deccan Chargers,Pune Warriors,normal,137,137,90,43,0,94,60,82,1,55,30,112,3,25,0,Pune Warriors,0,6,1,1,1,1
287,2011,Kings XI Punjab,Mumbai Indians,normal,164,87,90,28,3,59,60,63,6,24,30,87,10,0,0,Kings XI Punjab,76,0,0,0,0,0
288,2011,Rajasthan Royals,Royal Challengers Bangalore,normal,147,151,90,50,0,101,60,90,1,61,30,126,1,25,0,Royal Challengers Bangalore,0,9,1,1,1,1
289,2011,Chennai Super Kings,Delhi Daredevils,normal,177,158,90,46,1,112,60,65,3,93,30,107,3,51,0,Chennai Super Kings,18,0,0,1,0,0
290,2011,Kochi Tuskers Kerala,Kings XI Punjab,normal,179,181,90,35,2,146,60,84,2,97,30,145,4,36,0,Kings XI Punjab,0,6,1,0,1,1
292,2011,Deccan Chargers,Mumbai Indians,normal,136,125,90,24,2,101,60,49,3,76,30,76,4,49,0,Deccan Chargers,10,0,0,0,0,0
293,2011,Kings XI Punjab,Delhi Daredevils,normal,171,141,90,25,0,116,60,67,2,74,30,97,5,44,0,Kings XI Punjab,29,0,0,1,0,0
294,2011,Rajasthan Royals,Kochi Tuskers Kerala,normal,98,98,90,73,2,25,60,98,2,0,30,98,2,0,0,Kochi Tuskers Kerala,0,8,1,1,1,1
295,2011,Pune Warriors,Deccan Chargers,normal,137,138,90,40,0,98,60,78,2,60,30,108,2,30,0,Deccan Chargers,0,6,1,1,1,1
296,2011,Kings XI Punjab,Royal Challengers Bangalore,normal,233,121,90,27,2,94,60,69,4,52,30,97,8,24,0,Kings XI Punjab,111,0,0,0,0,0
297,2011,Chennai Super Kings,Kochi Tuskers Kerala,normal,153,141,90,29,1,112,60,63,2,78,30,90,3,51,0,Chennai Super Kings,11,0,0,0,1,0
298,2011,Pune Warriors,Kolkata Knight Riders,normal,119,119,90,43,1,76,60,74,2,45,30,114,2,5,0,Kolkata Knight Riders,0,7,1,1,1,1
299,2011,Mumbai Indians,Rajasthan Royals,normal,134,134,90,37,0,97,60,97,0,37,30,134,0,0,0,Rajasthan Royals,0,10,1,1,1,1
300,2011,Deccan Chargers,Kings XI Punjab,normal,199,116,90,36,2,80,60,77,2,39,30,99,5,17,0,Deccan Chargers,82,0,0,0,0,0
302,2011,Chennai Super Kings,Royal Challengers Bangalore,normal,129,129,90,34,1,95,60,80,2,49,30,104,2,25,0,Royal Challengers Bangalore,0,8,1,1,1,1
303,2011,Kolkata Knight Riders,Mumbai Indians,normal,176,178,90,36,1,142,60,84,2,94,30,110,4,68,0,Mumbai Indians,0,5,1,1,1,0
304,2011,Royal Challengers Bangalore,Chennai Super Kings,normal,176,177,90,24,2,153,60,62,2,115,30,110,3,67,0,Chennai Super Kings,0,6,1,0,0,0
305,2011,Kolkata Knight Riders,Mumbai Indians,normal,148,148,90,51,0,97,60,87,2,61,30,120,4,28,0,Mumbai Indians,0,4,1,1,1,1
306,2011,Royal Challengers Bangalore,Mumbai Indians,normal,186,142,90,41,1,101,60,80,3,62,30,103,7,39,0,Royal Challengers Bangalore,43,0,0,1,0,0
307,2011,Chennai Super Kings,Royal Challengers Bangalore,normal,206,147,90,38,2,109,60,69,5,78,30,107,7,40,0,Chennai Super Kings,58,0,0,0,0,0
308,2012,Chennai Super Kings,Mumbai Indians,normal,113,115,90,37,0,78,60,76,3,39,30,100,3,15,0,Mumbai Indians,0,8,1,1,1,1
309,2012,Kolkata Knight Riders,Delhi Daredevils,normal,98,100,90,39,0,61,60,87,2,13,30,100,2,0,0,Delhi Daredevils,0,8,1,1,1,1
310,2012,Pune Warriors,Mumbai Indians,normal,130,101,90,21,3,80,60,48,3,53,30,74,5,27,0,Pune Warriors,28,0,0,0,0,0
311,2012,Rajasthan Royals,Kings XI Punjab,normal,192,160,90,40,1,120,60,73,4,87,30,117,5,43,0,Rajasthan Royals,31,0,0,1,0,0
312,2012,Royal Challengers Bangalore,Delhi Daredevils,normal,158,137,90,40,1,97,60,68,3,69,30,91,5,46,0,Royal Challengers Bangalore,20,0,0,1,0,0
313,2012,Chennai Super Kings,Deccan Chargers,normal,194,119,90,35,1,84,60,73,2,46,30,101,8,18,0,Chennai Super Kings,74,0,0,0,0,0
314,2012,Rajasthan Royals,Kolkata Knight Riders,normal,165,142,90,23,3,119,60,65,4,77,30,94,7,48,0,Rajasthan Royals,22,0,0,0,0,0
315,2012,Pune Warriors,Kings XI Punjab,normal,167,144,90,13,2,131,60,53,3,91,30,99,5,45,0,Pune Warriors,22,0,0,0,0,0
316,2012,Deccan Chargers,Mumbai Indians,normal,139,142,90,15,2,127,60,49,2,93,30,85,3,57,0,Mumbai Indians,0,5,1,0,0,0
317,2012,Kolkata Knight Riders,Royal Challengers Bangalore,normal,166,123,90,20,2,103,60,43,5,80,30,81,7,42,0,Kolkata Knight Riders,42,0,0,0,0,0
318,2012,Chennai Super Kings,Delhi Daredevils,normal,111,111,90,44,1,67,60,79,2,32,30,111,2,0,0,Delhi Daredevils,0,8,1,1,1,1
319,2012,Mumbai Indians,Rajasthan Royals,normal,198,170,90,35,2,135,60,79,2,91,30,136,5,34,0,Mumbai Indians,27,0,0,0,1,0
320,2012,Royal Challengers Bangalore,Chennai Super Kings,normal,206,208,90,32,0,176,60,85,1,123,30,131,3,77,0,Chennai Super Kings,0,5,1,1,1,0
321,2012,Pune Warriors,Kings XI Punjab,normal,116,116,90,28,1,88,60,60,2,56,30,88,3,28,0,Kings XI Punjab,0,7,1,1,1,1
322,2012,Rajasthan Royals,Kolkata Knight Riders,normal,132,137,90,26,1,111,60,68,1,69,30,95,3,42,0,Kolkata Knight Riders,0,5,1,1,1,1
323,2012,Deccan Chargers,Delhi Daredevils,normal,158,162,90,27,3,135,60,71,4,91,30,115,5,47,0,Delhi Daredevils,0,5,1,0,0,1
324,2012,Chennai Super Kings,Pune Warriors,normal,156,156,90,48,1,108,60,72,2,84,30,106,3,50,0,Pune Warriors,0,7,1,1,1,1
325,2012,Kings XI Punjab,Kolkata Knight Riders,normal,135,132,90,41,2,91,60,70,2,62,30,94,6,38,0,Kings XI Punjab,2,0,0,1,1,0
326,2012,Rajasthan Royals,Royal Challengers Bangalore,normal,196,136,90,42,2,94,60,76,3,60,30,105,6,31,0,Rajasthan Royals,59,0,0,0,0,0
327,2012,Mumbai Indians,Delhi Daredevils,normal,93,93,90,34,0,59,60,58,2,35,30,93,3,0,0,Delhi Daredevils,0,7,1,1,1,1
328,2012,Deccan Chargers,Rajasthan Royals,normal,197,197,90,50,0,147,60,89,1,108,30,134,3,63,0,Rajasthan Royals,0,5,1,1,1,1
329,2012,Pune Warriors,Royal Challengers Bangalore,normal,183,186,90,40,1,146,60,63,2,123,30,117,3,69,0,Royal Challengers Bangalore,0,6,1,1,0,0
330,2012,Kings XI Punjab,Kolkata Knight Riders,normal,125,127,90,47,0,80,60,75,2,52,30,107,2,20,0,Kolkata Knight Riders,0,8,1,1,1,1
331,2012,Deccan Chargers,Delhi Daredevils,normal,188,193,90,44,1,149,60,112,1,81,30,167,1,26,0,Delhi Daredevils,0,9,1,1,1,1
332,2012,Chennai Super Kings,Pune Warriors,normal,165,151,90,35,2,116,60,65,4,86,30,107,5,44,0,Chennai Super Kings,13,0,0,0,0,0
333,2012,Kings XI Punjab,Royal Challengers Bangalore,normal,164,166,90,25,2,141,60,72,3,94,30,116,3,50,0,Royal Challengers Bangalore,0,5,1,0,1,1
334,2012,Rajasthan Royals,Chennai Super Kings,normal,147,147,90,40,0,107,60,70,1,77,30,104,1,43,0,Chennai Super Kings,0,7,1,1,1,1
335,2012,Pune Warriors,Delhi Daredevils,normal,193,172,90,29,1,143,60,92,2,80,30,131,5,41,0,Pune Warriors,20,0,0,0,1,0
336,2012,Mumbai Indians,Kings XI Punjab,normal,164,164,90,42,0,122,60,75,2,89,30,119,2,45,0,Kings XI Punjab,0,6,1,1,1,1
337,2012,Deccan Chargers,Kolkata Knight Riders,normal,127,127,90,32,1,95,60,65,3,62,30,97,4,30,0,Kolkata Knight Riders,0,5,1,1,1,1
338,2012,Royal Challengers Bangalore,Rajasthan Royals,normal,190,143,90,35,0,108,60,67,1,76,30,103,5,40,0,Royal Challengers Bangalore,46,0,0,1,0,0
339,2012,Pune Warriors,Delhi Daredevils,normal,147,148,90,46,1,102,60,99,1,49,30,134,2,14,0,Delhi Daredevils,0,8,1,1,1,1
340,2012,Kings XI Punjab,Mumbai Indians,normal,169,171,90,29,0,142,60,64,2,107,30,106,4,65,0,Mumbai Indians,0,4,1,1,0,0
341,2012,Deccan Chargers,Pune Warriors,normal,178,159,90,39,1,120,60,73,3,86,30,101,5,58,0,Deccan Chargers,18,0,0,1,0,0
342,2012,Delhi Daredevils,Mumbai Indians,normal,208,170,90,36,3,134,60,88,3,82,30,139,4,31,0,Delhi Daredevils,37,0,0,0,0,1
343,2012,Kings XI Punjab,Chennai Super Kings,normal,157,149,90,45,0,104,60,69,2,80,30,99,6,50,0,Kings XI Punjab,7,0,0,1,1,0
344,2012,Kolkata Knight Riders,Royal Challengers Bangalore,normal,191,143,90,32,1,111,60,56,3,87,30,87,4,56,0,Kolkata Knight Riders,47,0,0,0,0,0
345,2012,Delhi Daredevils,Rajasthan Royals,normal,153,151,90,30,0,121,60,67,0,84,30,108,1,43,0,Delhi Daredevils,1,0,0,1,1,1
346,2012,Deccan Chargers,Mumbai Indians,normal,101,101,90,27,1,74,60,52,3,49,30,77,4,24,0,Mumbai Indians,0,5,1,1,1,1
347,2012,Chennai Super Kings,Kolkata Knight Riders,normal,140,140,90,31,1,109,60,68,1,72,30,103,2,37,0,Kolkata Knight Riders,0,5,1,1,1,1
348,2012,Deccan Chargers,Pune Warriors,normal,187,173,90,31,1,142,60,75,1,98,30,116,3,57,0,Deccan Chargers,13,0,0,0,1,0
349,2012,Rajasthan Royals,Delhi Daredevils,normal,142,144,90,51,1,93,60,96,1,48,30,134,4,10,0,Delhi Daredevils,0,6,1,1,1,1
350,2012,Royal Challengers Bangalore,Kings XI Punjab,normal,159,163,90,44,1,119,60,80,2,83,30,132,2,31,0,Kings XI Punjab,0,4,1,1,1,1
351,2012,Mumbai Indians,Pune Warriors,normal,121,119,90,31,1,88,60,47,4,72,30,76,4,43,0,Mumbai Indians,1,0,0,1,0,0
352,2012,Chennai Super Kings,Deccan Chargers,normal,161,150,90,40,1,110,60,76,1,74,30,102,3,48,0,Chennai Super Kings,10,0,0,1,1,0
353,2012,Kolkata Knight Riders,Pune Warriors,normal,151,143,90,35,2,108,60,66,5,77,30,109,5,34,0,Kolkata Knight Riders,7,0,0,0,0,1
354,2012,Rajasthan Royals,Kings XI Punjab,normal,178,134,90,27,1,107,60,65,4,69,30,97,5,37,0,Rajasthan Royals,43,0,0,0,0,0
355,2012,Chennai Super Kings,Mumbai Indians,normal,174,174,90,38,1,136,60,74,1,100,30,131,1,43,0,Mumbai Indians,0,2,1,1,1,1
356,2012,Deccan Chargers,Royal Challengers Bangalore,normal,182,185,90,36,0,149,60,83,0,102,30,113,3,72,0,Royal Challengers Bangalore,0,5,1,1,1,0
357,2012,Delhi Daredevils,Kolkata Knight Riders,normal,154,154,90,50,0,104,60,80,1,74,30,128,1,26,0,Kolkata Knight Riders,0,6,1,1,1,1
358,2012,Pune Warriors,Rajasthan Royals,normal,126,126,90,41,1,85,60,79,2,47,30,112,3,14,0,Rajasthan Royals,0,7,1,1,1,1
359,2012,Kings XI Punjab,Deccan Chargers,normal,171,145,90,31,2,114,60,70,2,75,30,99,5,46,0,Kings XI Punjab,25,0,0,0,1,0
360,2012,Mumbai Indians,Royal Challengers Bangalore,normal,142,142,90,27,0,115,60,54,1,88,30,111,1,31,0,Royal Challengers Bangalore,0,9,1,1,1,1
361,2012,Rajasthan Royals,Chennai Super Kings,normal,127,127,90,30,1,97,60,53,2,74,30,77,4,50,0,Chennai Super Kings,0,4,1,1,1,0
362,2012,Royal Challengers Bangalore,Pune Warriors,normal,174,138,90,38,3,100,60,80,4,58,30,105,6,33,0,Royal Challengers Bangalore,35,0,0,0,0,0
363,2012,Mumbai Indians,Kolkata Knight Riders,normal,183,155,90,23,2,132,60,61,3,94,30,106,3,49,0,Mumbai Indians,27,0,0,0,0,0
364,2012,Delhi Daredevils,Chennai Super Kings,normal,115,115,90,38,0,77,60,75,0,40,30,112,1,3,0,Chennai Super Kings,0,9,1,1,1,1
365,2012,Rajasthan Royals,Pune Warriors,normal,171,125,90,26,4,99,60,60,4,65,30,97,6,28,0,Rajasthan Royals,45,0,0,0,0,0
366,2012,Deccan Chargers,Kings XI Punjab,normal,191,194,90,28,2,166,60,76,3,118,30,130,4,64,0,Kings XI Punjab,0,4,1,0,0,1
367,2012,Royal Challengers Bangalore,Mumbai Indians,normal,172,173,90,28,3,145,60,56,5,117,30,106,5,67,0,Mumbai Indians,0,5,1,0,0,0
368,2012,Kolkata Knight Riders,Chennai Super Kings,normal,159,160,90,44,0,116,60,96,0,64,30,115,3,45,0,Chennai Super Kings,0,5,1,1,1,1
369,2012,Kings XI Punjab,Delhi Daredevils,normal,137,140,90,36,2,104,60,55,4,85,30,103,5,37,0,Delhi Daredevils,0,5,1,1,0,1
370,2012,Kolkata Knight Riders,Mumbai Indians,normal,141,108,90,20,0,88,60,59,1,49,30,80,3,28,0,Kolkata Knight Riders,32,0,0,0,1,0
371,2012,Chennai Super Kings,Kings XI Punjab,normal,121,123,90,34,0,89,60,65,2,58,30,114,3,9,0,Kings XI Punjab,0,6,1,1,1,1
372,2012,Royal Challengers Bangalore,Delhi Daredevils,normal,216,194,90,47,2,147,60,96,3,98,30,149,4,45,0,Royal Challengers Bangalore,21,0,0,0,1,1
373,2012,Rajasthan Royals,Deccan Chargers,normal,127,128,90,44,0,84,60,69,1,59,30,99,3,29,0,Deccan Chargers,0,5,1,1,1,1
374,2012,Kings XI Punjab,Delhi Daredevils,normal,142,145,90,34,0,111,60,87,1,58,30,118,3,27,0,Delhi Daredevils,0,6,1,1,1,1
375,2012,Kolkata Knight Riders,Pune Warriors,normal,137,102,90,35,1,67,60,61,3,41,30,82,4,20,0,Kolkata Knight Riders,34,0,0,1,1,0
376,2012,Deccan Chargers,Royal Challengers Bangalore,normal,133,123,90,37,2,86,60,57,4,66,30,89,4,34,0,Deccan Chargers,9,0,0,1,0,1
377,2012,Rajasthan Royals,Mumbai Indians,normal,163,163,90,39,0,124,60,79,0,84,30,140,0,23,0,Mumbai Indians,0,10,1,1,1,1
378,2012,Kolkata Knight Riders,Delhi Daredevils,normal,163,144,90,47,2,97,60,83,2,61,30,109,4,35,0,Kolkata Knight Riders,18,0,0,1,1,1
379,2012,Chennai Super Kings,Mumbai Indians,normal,188,149,90,47,1,102,60,77,3,72,30,112,7,37,0,Chennai Super Kings,38,0,0,1,0,0
380,2012,Chennai Super Kings,Delhi Daredevils,normal,223,136,90,35,2,101,60,89,3,47,30,128,7,8,0,Chennai Super Kings,86,0,0,0,0,0
381,2012,Chennai Super Kings,Kolkata Knight Riders,normal,191,192,90,41,1,151,60,100,1,92,30,141,2,51,0,Kolkata Knight Riders,0,5,1,1,1,1
382,2013,Delhi Daredevils,Kolkata Knight Riders,normal,129,129,90,40,1,89,60,75,2,54,30,100,4,29,0,Kolkata Knight Riders,0,6,1,1,1,1
383,2013,Royal Challengers Bangalore,Mumbai Indians,normal,157,154,90,27,0,127,60,62,2,92,30,96,3,58,0,Royal Challengers Bangalore,2,0,0,1,1,0
384,2013,Sunrisers Hyderabad,Pune Warriors,normal,127,104,90,18,0,86,60,48,3,56,30,78,4,26,0,Sunrisers Hyderabad,22,0,0,0,0,0
385,2013,Rajasthan Royals,Delhi Daredevils,normal,166,160,90,33,0,127,60,73,1,87,30,120,2,40,0,Rajasthan Royals,5,0,0,1,1,1
386,2013,Mumbai Indians,Chennai Super Kings,normal,149,139,90,32,2,107,60,58,3,81,30,93,5,46,0,Mumbai Indians,9,0,0,0,0,0
387,2013,Pune Warriors,Kings XI Punjab,normal,100,100,90,54,1,46,60,84,2,16,30,100,2,0,0,Kings XI Punjab,0,8,1,1,1,1
388,2013,Royal Challengers Bangalore,Sunrisers Hyderabad,tie,131,130,90,31,2,99,60,56,3,74,30,91,4,39,0,Sunrisers Hyderabad,0,0,1,0,0,1
389,2013,Rajasthan Royals,Kolkata Knight Riders,normal,145,125,90,36,2,89,60,55,5,70,30,99,7,26,0,Rajasthan Royals,19,0,0,0,0,0
390,2013,Mumbai Indians,Delhi Daredevils,normal,210,165,90,42,2,123,60,84,2,81,30,126,5,39,0,Mumbai Indians,44,0,0,0,1,0
391,2013,Kings XI Punjab,Chennai Super Kings,normal,139,139,90,31,0,108,60,65,0,74,30,103,0,36,0,Chennai Super Kings,0,10,1,1,1,1
392,2013,Kolkata Knight Riders,Royal Challengers Bangalore,normal,155,158,90,21,1,137,60,80,2,78,30,117,2,41,0,Royal Challengers Bangalore,0,8,1,0,1,1
393,2013,Rajasthan Royals,Pune Warriors,normal,146,148,90,58,1,90,60,87,1,61,30,117,2,31,0,Pune Warriors,0,7,1,1,1,1
394,2013,Delhi Daredevils,Sunrisers Hyderabad,normal,115,115,90,25,1,90,60,51,2,64,30,76,5,39,0,Sunrisers Hyderabad,0,3,1,1,1,0
395,2013,Mumbai Indians,Pune Warriors,normal,184,142,90,34,3,108,60,72,5,70,30,118,6,24,0,Mumbai Indians,41,0,0,0,0,0
396,2013,Royal Challengers Bangalore,Chennai Super Kings,normal,166,166,90,17,2,149,60,64,2,102,30,101,4,65,0,Chennai Super Kings,0,4,1,0,0,0
397,2013,Kolkata Knight Riders,Sunrisers Hyderabad,normal,181,132,90,33,0,99,60,68,1,64,30,104,3,28,0,Kolkata Knight Riders,48,0,0,1,1,0
398,2013,Kings XI Punjab,Rajasthan Royals,normal,125,126,90,44,1,82,60,68,3,58,30,94,4,32,0,Rajasthan Royals,0,6,1,1,1,1
399,2013,Pune Warriors,Chennai Super Kings,normal,160,135,90,25,2,110,60,63,3,72,30,99,5,36,0,Pune Warriors,24,0,0,0,0,0
400,2013,Kings XI Punjab,Kolkata Knight Riders,normal,158,153,90,34,2,119,60,82,2,71,30,116,4,37,0,Kings XI Punjab,4,0,0,0,1,1
401,2013,Delhi Daredevils,Royal Challengers Bangalore,tie,153,152,90,43,2,109,60,84,2,68,30,126,2,26,0,Royal Challengers Bangalore,0,0,1,1,1,1
402,2013,Sunrisers Hyderabad,Pune Warriors,normal,120,108,90,39,2,69,60,65,3,43,30,87,4,21,0,Sunrisers Hyderabad,11,0,0,1,1,1
403,2013,Rajasthan Royals,Mumbai Indians,normal,180,92,90,24,2,68,60,42,4,50,30,71,7,21,0,Rajasthan Royals,87,0,0,0,0,0
404,2013,Chennai Super Kings,Delhi Daredevils,normal,170,83,90,30,3,53,60,58,4,25,30,80,7,3,0,Chennai Super Kings,86,0,0,0,0,0
405,2013,Kings XI Punjab,Sunrisers Hyderabad,normal,124,127,90,25,1,102,60,56,2,71,30,87,3,40,0,Sunrisers Hyderabad,0,5,1,1,1,1
406,2013,Kolkata Knight Riders,Chennai Super Kings,normal,120,124,90,26,1,98,60,48,3,76,30,70,4,54,0,Chennai Super Kings,0,4,1,1,0,0
407,2013,Rajasthan Royals,Royal Challengers Bangalore,normal,118,123,90,46,0,77,60,67,3,56,30,98,3,25,0,Royal Challengers Bangalore,0,7,1,1,1,1
408,2013,Mumbai Indians,Delhi Daredevils,normal,162,165,90,51,0,114,60,102,0,63,30,144,0,21,0,Delhi Daredevils,0,9,1,1,1,1
409,2013,Pune Warriors,Kings XI Punjab,normal,186,186,90,44,2,142,60,83,3,103,30,129,3,57,0,Kings XI Punjab,0,7,1,0,1,1
410,2013,Rajasthan Royals,Chennai Super Kings,normal,186,186,90,45,1,141,60,92,1,94,30,140,2,46,0,Chennai Super Kings,0,5,1,1,1,1
411,2013,Royal Challengers Bangalore,Pune Warriors,normal,264,133,90,37,2,96,60,76,4,57,30,111,5,22,0,Royal Challengers Bangalore,130,0,0,0,0,0
412,2013,Kings XI Punjab,Delhi Daredevils,normal,172,164,90,14,3,150,60,57,3,107,30,100,4,64,0,Kings XI Punjab,7,0,0,0,0,0
413,2013,Kolkata Knight Riders,Mumbai Indians,normal,160,162,90,30,1,132,60,79,2,83,30,116,3,46,0,Mumbai Indians,0,5,1,0,1,1
414,2013,Sunrisers Hyderabad,Chennai Super Kings,normal,160,160,90,46,0,114,60,76,2,84,30,114,3,46,0,Chennai Super Kings,0,5,1,1,1,1
415,2013,Kings XI Punjab,Kolkata Knight Riders,normal,150,150,90,36,2,114,60,75,2,75,30,118,3,32,0,Kolkata Knight Riders,0,6,1,0,1,1
416,2013,Sunrisers Hyderabad,Rajasthan Royals,normal,145,146,90,21,1,125,60,53,1,93,30,109,2,37,0,Rajasthan Royals,0,8,1,0,1,1
417,2013,Mumbai Indians,Royal Challengers Bangalore,normal,195,136,90,34,0,102,60,66,4,70,30,94,7,42,0,Mumbai Indians,58,0,0,1,0,0
418,2013,Chennai Super Kings,Kolkata Knight Riders,normal,201,186,90,51,1,135,60,85,2,101,30,126,3,60,0,Chennai Super Kings,14,0,0,1,1,0
419,2013,Delhi Daredevils,Pune Warriors,normal,165,149,90,37,0,112,60,75,0,74,30,110,2,39,0,Delhi Daredevils,15,0,0,1,1,1
420,2013,Royal Challengers Bangalore,Rajasthan Royals,normal,172,173,90,36,1,137,60,80,2,93,30,120,3,53,0,Rajasthan Royals,0,4,1,1,1,1
421,2013,Mumbai Indians,Kings XI Punjab,normal,175,170,90,38,2,132,60,80,5,90,30,118,7,52,0,Mumbai Indians,4,0,0,0,0,0
422,2013,Chennai Super Kings,Pune Warriors,normal,165,127,90,43,4,84,60,68,6,59,30,93,7,34,0,Chennai Super Kings,37,0,0,0,0,0
423,2013,Mumbai Indians,Sunrisers Hyderabad,normal,130,130,90,25,1,105,60,61,2,69,30,106,2,24,0,Sunrisers Hyderabad,0,7,1,1,1,1
424,2013,Kolkata Knight Riders,Delhi Daredevils,normal,137,137,90,32,2,105,60,56,2,81,30,100,2,37,0,Delhi Daredevils,0,7,1,0,1,1
425,2013,Chennai Super Kings,Kings XI Punjab,normal,187,171,90,27,1,144,60,65,2,106,30,122,3,49,0,Chennai Super Kings,15,0,0,0,0,1
426,2013,Royal Challengers Bangalore,Pune Warriors,normal,188,170,90,35,1,135,60,77,2,93,30,122,4,48,0,Royal Challengers Bangalore,17,0,0,0,1,0
427,2013,Rajasthan Royals,Kolkata Knight Riders,normal,133,133,90,40,0,93,60,82,2,51,30,114,2,19,0,Kolkata Knight Riders,0,8,1,1,1,1
428,2013,Delhi Daredevils,Sunrisers Hyderabad,normal,81,81,90,33,1,48,60,55,3,26,30,81,4,0,0,Sunrisers Hyderabad,0,6,1,1,1,1
429,2013,Royal Challengers Bangalore,Kings XI Punjab,normal,175,176,90,33,1,143,60,79,1,97,30,140,1,36,0,Kings XI Punjab,0,7,1,0,1,1
430,2013,Mumbai Indians,Chennai Super Kings,normal,140,79,90,21,4,58,60,48,6,31,30,78,9,1,0,Mumbai Indians,60,0,0,0,0,0
431,2013,Pune Warriors,Rajasthan Royals,normal,179,182,90,40,0,142,60,84,0,98,30,128,2,54,0,Rajasthan Royals,0,5,1,1,1,1
432,2013,Sunrisers Hyderabad,Royal Challengers Bangalore,normal,162,162,90,39,0,123,60,69,2,93,30,117,3,45,0,Royal Challengers Bangalore,0,7,1,1,1,1
433,2013,Delhi Daredevils,Rajasthan Royals,normal,155,155,90,36,0,119,60,77,0,78,30,126,1,29,0,Rajasthan Royals,0,9,1,1,1,1
434,2013,Mumbai Indians,Kolkata Knight Riders,normal,171,105,90,30,1,75,60,62,4,43,30,92,7,13,0,Mumbai Indians,65,0,0,0,0,0
435,2013,Chennai Super Kings,Sunrisers Hyderabad,normal,224,146,90,46,1,100,60,75,5,71,30,109,6,37,0,Chennai Super Kings,77,0,0,1,0,0
436,2013,Kings XI Punjab,Rajasthan Royals,normal,146,147,90,31,1,116,60,73,2,74,30,105,2,42,0,Rajasthan Royals,0,8,1,1,1,1
437,2013,Kolkata Knight Riders,Pune Warriors,normal,153,106,90,29,2,77,60,49,3,57,30,80,5,26,0,Kolkata Knight Riders,46,0,0,0,0,0
438,2013,Royal Challengers Bangalore,Delhi Daredevils,normal,184,179,90,48,1,131,60,88,3,91,30,123,4,56,0,Royal Challengers Bangalore,4,0,0,1,1,1
439,2013,Pune Warriors,Mumbai Indians,normal,113,116,90,26,2,90,60,50,3,66,30,83,3,33,0,Mumbai Indians,0,5,1,0,1,1
440,2013,Sunrisers Hyderabad,Kings XI Punjab,normal,151,120,90,29,1,91,60,54,4,66,30,93,4,27,0,Sunrisers Hyderabad,30,0,0,1,0,0
441,2013,Royal Challengers Bangalore,Kolkata Knight Riders,normal,116,116,90,27,1,89,60,61,2,55,30,85,3,31,0,Kolkata Knight Riders,0,5,1,1,1,1
442,2013,Chennai Super Kings,Rajasthan Royals,normal,142,144,90,19,3,125,60,49,4,95,30,130,4,14,0,Rajasthan Royals,0,5,1,0,0,1
443,2013,Delhi Daredevils,Kings XI Punjab,normal,121,121,90,51,3,70,60,77,4,44,30,101,4,20,0,Kings XI Punjab,0,5,1,1,1,1
444,2013,Sunrisers Hyderabad,Mumbai Indians,normal,179,184,90,35,1,149,60,73,1,111,30,113,4,71,0,Mumbai Indians,0,7,1,1,1,0
445,2013,Pune Warriors,Kolkata Knight Riders,normal,171,163,90,30,3,133,60,74,3,89,30,122,3,41,0,Pune Warriors,7,0,0,0,0,1
446,2013,Chennai Super Kings,Delhi Daredevils,normal,169,135,90,34,2,101,60,65,5,70,30,103,6,32,0,Chennai Super Kings,33,0,0,0,0,0
447,2013,Mumbai Indians,Rajasthan Royals,normal,167,152,90,27,3,125,60,60,5,92,30,106,6,46,0,Mumbai Indians,14,0,0,0,0,0
448,2013,Royal Challengers Bangalore,Kings XI Punjab,normal,191,194,90,31,2,163,60,68,4,126,30,138,4,56,0,Kings XI Punjab,0,6,1,0,0,1
449,2013,Sunrisers Hyderabad,Rajasthan Royals,normal,137,113,90,30,0,83,60,44,2,69,30,73,5,40,0,Sunrisers Hyderabad,23,0,0,1,0,0
450,2013,Kings XI Punjab,Mumbai Indians,normal,184,133,90,37,2,96,60,69,4,64,30,107,5,26,0,Kings XI Punjab,50,0,0,0,0,0
451,2013,Pune Warriors,Delhi Daredevils,normal,173,134,90,40,2,94,60,65,5,69,30,104,5,30,0,Pune Warriors,38,0,0,0,0,0
453,2013,Kolkata Knight Riders,Sunrisers Hyderabad,normal,131,132,90,30,0,102,60,77,0,55,30,106,3,26,0,Sunrisers Hyderabad,0,5,1,1,1,1
454,2013,Chennai Super Kings,Mumbai Indians,normal,193,144,90,40,1,104,60,92,2,52,30,127,5,17,0,Chennai Super Kings,48,0,0,1,1,0
455,2013,Sunrisers Hyderabad,Rajasthan Royals,normal,133,135,90,28,1,107,60,57,5,78,30,99,5,36,0,Rajasthan Royals,0,4,1,1,0,1
456,2013,Rajasthan Royals,Mumbai Indians,normal,166,169,90,36,0,133,60,73,1,96,30,126,2,43,0,Mumbai Indians,0,4,1,1,1,1
457,2013,Mumbai Indians,Chennai Super Kings,normal,149,125,90,29,3,96,60,54,6,71,30,83,8,42,0,Mumbai Indians,23,0,0,0,0,0
458,2014,Kolkata Knight Riders,Mumbai Indians,normal,164,122,90,25,1,97,60,54,2,68,30,95,2,27,0,Kolkata Knight Riders,41,0,0,0,0,0
459,2014,Delhi Daredevils,Royal Challengers Bangalore,normal,146,146,90,37,1,109,60,69,2,77,30,124,2,22,0,Royal Challengers Bangalore,0,8,1,1,1,1
460,2014,Chennai Super Kings,Kings XI Punjab,normal,206,206,90,52,2,154,60,93,3,113,30,156,3,50,0,Kings XI Punjab,0,6,1,1,1,1
461,2014,Sunrisers Hyderabad,Rajasthan Royals,normal,134,135,90,28,2,107,60,61,3,74,30,102,3,33,0,Rajasthan Royals,0,4,1,0,1,1
462,2014,Mumbai Indians,Royal Challengers Bangalore,normal,116,116,90,24,3,92,60,50,3,66,30,92,3,24,0,Royal Challengers Bangalore,0,7,1,0,0,1
463,2014,Kolkata Knight Riders,Delhi Daredevils,normal,167,167,90,43,2,124,60,84,3,83,30,123,4,44,0,Delhi Daredevils,0,4,1,1,1,1
464,2014,Rajasthan Royals,Kings XI Punjab,normal,192,193,90,30,2,163,60,69,2,124,30,132,3,61,0,Kings XI Punjab,0,7,1,0,0,1
465,2014,Chennai Super Kings,Delhi Daredevils,normal,178,84,90,18,3,66,60,53,5,31,30,82,8,2,0,Chennai Super Kings,93,0,0,0,0,0
466,2014,Kings XI Punjab,Sunrisers Hyderabad,normal,194,121,90,33,3,88,60,74,4,47,30,99,7,22,0,Kings XI Punjab,72,0,0,0,0,0
467,2014,Chennai Super Kings,Rajasthan Royals,normal,141,133,90,37,1,96,60,56,4,77,30,87,8,46,0,Chennai Super Kings,7,0,0,1,0,0
468,2014,Kolkata Knight Riders,Royal Challengers Bangalore,normal,151,148,90,34,0,114,60,77,2,71,30,116,2,32,0,Kolkata Knight Riders,2,0,0,1,1,1
469,2014,Sunrisers Hyderabad,Delhi Daredevils,normal,185,180,90,37,0,143,60,86,0,94,30,119,2,61,0,Sunrisers Hyderabad,4,0,0,1,1,1
470,2014,Mumbai Indians,Chennai Super Kings,normal,142,142,90,37,0,105,60,76,2,66,30,107,2,35,0,Chennai Super Kings,0,7,1,1,1,1
471,2014,Royal Challengers Bangalore,Rajasthan Royals,normal,71,71,90,32,1,39,60,48,3,23,30,71,4,0,0,Rajasthan Royals,0,6,1,1,1,1
472,2014,Kings XI Punjab,Kolkata Knight Riders,normal,133,109,90,19,2,90,60,43,3,66,30,75,7,34,0,Kings XI Punjab,23,0,0,0,0,0
473,2014,Mumbai Indians,Delhi Daredevils,normal,126,126,90,30,0,96,60,55,1,71,30,103,2,23,0,Delhi Daredevils,0,6,1,1,1,1
474,2014,Sunrisers Hyderabad,Chennai Super Kings,normal,146,146,90,36,0,110,60,75,0,71,30,124,2,22,0,Chennai Super Kings,0,5,1,1,1,1
475,2014,Royal Challengers Bangalore,Kings XI Punjab,normal,125,127,90,31,1,96,60,63,3,64,30,101,5,26,0,Kings XI Punjab,0,5,1,1,1,1
476,2014,Rajasthan Royals,Kolkata Knight Riders,tie,153,152,90,30,1,122,60,59,2,93,30,101,4,51,0,Rajasthan Royals,0,0,0,1,0,0
477,2014,Sunrisers Hyderabad,Mumbai Indians,normal,173,157,90,24,2,133,60,60,3,97,30,106,3,51,0,Sunrisers Hyderabad,15,0,0,0,0,0
478,2014,Chennai Super Kings,Kolkata Knight Riders,normal,149,114,90,38,2,76,60,66,5,48,30,91,7,23,0,Chennai Super Kings,34,0,0,1,0,0
479,2014,Kings XI Punjab,Mumbai Indians,normal,169,170,90,42,2,128,60,70,3,100,30,118,3,52,0,Mumbai Indians,0,5,1,0,0,1
480,2014,Delhi Daredevils,Rajasthan Royals,normal,153,156,90,31,1,125,60,71,2,85,30,115,3,41,0,Rajasthan Royals,0,7,1,1,1,1
481,2014,Sunrisers Hyderabad,Royal Challengers Bangalore,normal,156,158,90,32,2,126,60,59,3,99,30,97,5,61,0,Royal Challengers Bangalore,0,4,1,0,0,0
482,2014,Rajasthan Royals,Kolkata Knight Riders,normal,171,160,90,39,0,121,60,80,0,80,30,122,3,38,0,Rajasthan Royals,10,0,0,1,1,1
483,2014,Delhi Daredevils,Chennai Super Kings,normal,179,181,90,47,0,134,60,69,0,112,30,127,1,54,0,Chennai Super Kings,0,8,1,1,1,1
484,2014,Mumbai Indians,Royal Challengers Bangalore,normal,188,168,90,53,0,115,60,98,2,70,30,125,4,43,0,Mumbai Indians,19,0,0,1,1,1
485,2014,Delhi Daredevils,Kolkata Knight Riders,normal,161,161,90,42,0,119,60,90,0,71,30,128,1,33,0,Kolkata Knight Riders,0,8,1,1,1,1
486,2014,Kings XI Punjab,Chennai Super Kings,normal,232,187,90,34,1,153,60,85,2,102,30,119,4,68,0,Kings XI Punjab,44,0,0,0,0,0
487,2014,Sunrisers Hyderabad,Rajasthan Royals,normal,135,102,90,32,2,70,60,60,4,42,30,81,5,21,0,Sunrisers Hyderabad,32,0,0,0,0,0
488,2014,Kings XI Punjab,Royal Challengers Bangalore,normal,199,166,90,22,2,144,60,52,5,114,30,109,6,57,0,Kings XI Punjab,32,0,0,0,0,0
490,2014,Mumbai Indians,Chennai Super Kings,normal,158,160,90,34,1,126,60,75,2,85,30,112,2,48,0,Chennai Super Kings,0,4,1,1,1,1
491,2014,Kings XI Punjab,Kolkata Knight Riders,normal,150,150,90,48,0,102,60,89,1,61,30,123,1,27,0,Kolkata Knight Riders,0,9,1,1,1,1
492,2014,Royal Challengers Bangalore,Rajasthan Royals,normal,191,191,90,38,0,153,60,68,3,123,30,122,5,69,0,Rajasthan Royals,0,5,1,1,0,0
493,2014,Sunrisers Hyderabad,Mumbai Indians,normal,158,160,90,32,1,128,60,75,1,85,30,125,1,35,0,Mumbai Indians,0,7,1,1,1,1
494,2014,Rajasthan Royals,Chennai Super Kings,normal,149,149,90,42,2,107,60,76,3,73,30,106,4,43,0,Chennai Super Kings,0,5,1,1,1,1
495,2014,Royal Challengers Bangalore,Delhi Daredevils,normal,187,170,90,36,2,134,60,76,3,94,30,119,5,51,0,Royal Challengers Bangalore,16,0,0,0,0,0
496,2014,Sunrisers Hyderabad,Kings XI Punjab,normal,206,211,90,66,1,145,60,131,3,80,30,169,4,42,0,Kings XI Punjab,0,6,1,1,1,1
497,2014,Mumbai Indians,Kolkata Knight Riders,normal,142,142,90,40,0,102,60,68,1,74,30,100,2,42,0,Kolkata Knight Riders,0,6,1,1,1,1
498,2014,Rajasthan Royals,Delhi Daredevils,normal,202,139,90,30,2,109,60,62,5,77,30,93,8,46,0,Rajasthan Royals,62,0,0,0,0,0
499,2014,Chennai Super Kings,Royal Challengers Bangalore,normal,139,142,90,17,1,125,60,45,1,97,30,86,2,56,0,Royal Challengers Bangalore,0,5,1,0,0,0
500,2014,Sunrisers Hyderabad,Kolkata Knight Riders,normal,143,146,90,21,1,125,60,60,2,86,30,103,2,43,0,Kolkata Knight Riders,0,7,1,0,1,1
501,2014,Mumbai Indians,Rajasthan Royals,normal,179,153,90,41,2,112,60,69,5,84,30,96,7,57,0,Mumbai Indians,25,0,0,0,0,0
502,2014,Delhi Daredevils,Kings XI Punjab,normal,165,165,90,55,0,110,60,95,4,70,30,127,5,38,0,Kings XI Punjab,0,4,1,1,1,1
503,2014,Royal Challengers Bangalore,Sunrisers Hyderabad,normal,161,161,90,45,0,116,60,72,0,89,30,116,1,45,0,Sunrisers Hyderabad,0,7,1,1,1,1
504,2014,Chennai Super Kings,Kolkata Knight Riders,normal,155,156,90,45,0,111,60,88,1,68,30,119,2,37,0,Kolkata Knight Riders,0,8,1,1,1,1
505,2014,Kings XI Punjab,Mumbai Indians,normal,157,159,90,53,0,106,60,96,1,63,30,133,2,26,0,Mumbai Indians,0,7,1,1,1,1
506,2014,Kolkata Knight Riders,Royal Challengers Bangalore,normal,196,165,90,30,1,135,60,72,1,93,30,106,3,59,0,Kolkata Knight Riders,30,0,0,0,1,0
507,2014,Chennai Super Kings,Sunrisers Hyderabad,normal,186,189,90,43,0,146,60,100,0,89,30,148,1,41,0,Sunrisers Hyderabad,0,6,1,1,1,1
508,2014,Mumbai Indians,Delhi Daredevils,normal,174,158,90,43,0,115,60,62,3,96,30,105,3,53,0,Mumbai Indians,15,0,0,1,0,0
509,2014,Kings XI Punjab,Rajasthan Royals,normal,180,163,90,31,1,132,60,64,3,99,30,92,5,71,0,Kings XI Punjab,16,0,0,0,0,0
510,2014,Royal Challengers Bangalore,Chennai Super Kings,normal,155,160,90,59,1,101,60,87,2,73,30,111,2,49,0,Chennai Super Kings,0,8,1,1,1,1
511,2014,Sunrisers Hyderabad,Kolkata Knight Riders,normal,161,161,90,43,1,118,60,78,4,83,30,161,6,0,0,Kolkata Knight Riders,0,4,1,1,0,1
512,2014,Delhi Daredevils,Kings XI Punjab,normal,116,119,90,30,2,89,60,78,2,41,30,119,3,0,0,Kings XI Punjab,0,7,1,1,1,1
513,2014,Rajasthan Royals,Mumbai Indians,normal,190,195,90,61,3,134,60,120,4,75,30,195,5,0,0,Mumbai Indians,0,5,1,0,1,1
514,2014,Kolkata Knight Riders,Kings XI Punjab,normal,164,135,90,39,1,96,60,68,3,67,30,92,6,43,0,Kolkata Knight Riders,28,0,0,1,0,0
515,2014,Mumbai Indians,Chennai Super Kings,normal,174,176,90,43,0,133,60,89,3,87,30,132,3,44,0,Chennai Super Kings,0,7,1,1,1,1
516,2014,Kings XI Punjab,Chennai Super Kings,normal,227,202,90,67,2,135,60,122,3,80,30,155,6,47,0,Kings XI Punjab,24,0,0,1,1,0
517,2014,Kings XI Punjab,Kolkata Knight Riders,normal,200,200,90,48,1,152,60,89,2,111,30,151,3,49,0,Kolkata Knight Riders,0,3,1,1,1,1
518,2015,Mumbai Indians,Kolkata Knight Riders,normal,169,170,90,32,1,138,60,85,1,85,30,129,3,41,0,Kolkata Knight Riders,0,7,1,0,1,1
519,2015,Chennai Super Kings,Delhi Daredevils,normal,151,149,90,39,3,110,60,67,3,82,30,102,5,47,0,Chennai Super Kings,1,0,0,0,1,0
520,2015,Rajasthan Royals,Kings XI Punjab,normal,163,136,90,46,3,90,60,66,4,70,30,104,5,32,0,Rajasthan Royals,26,0,0,0,0,0
521,2015,Chennai Super Kings,Sunrisers Hyderabad,normal,210,164,90,37,1,127,60,80,2,84,30,115,4,49,0,Chennai Super Kings,45,0,0,0,0,0
522,2015,Kolkata Knight Riders,Royal Challengers Bangalore,normal,178,179,90,29,1,150,60,77,3,102,30,119,5,60,0,Royal Challengers Bangalore,0,3,1,0,0,0
523,2015,Delhi Daredevils,Rajasthan Royals,normal,185,186,90,37,1,149,60,74,3,112,30,130,4,56,0,Rajasthan Royals,0,3,1,1,0,1
524,2015,Kings XI Punjab,Mumbai Indians,normal,178,159,90,17,2,142,60,32,4,127,30,79,6,80,0,Kings XI Punjab,18,0,0,0,0,0
525,2015,Royal Challengers Bangalore,Sunrisers Hyderabad,normal,167,172,90,58,0,114,60,95,2,77,30,137,2,35,0,Sunrisers Hyderabad,0,8,1,1,1,1
526,2015,Mumbai Indians,Rajasthan Royals,normal,165,165,90,33,1,132,60,69,1,96,30,113,3,52,0,Rajasthan Royals,0,7,1,1,1,1
527,2015,Chennai Super Kings,Kolkata Knight Riders,normal,166,169,90,36,1,133,60,66,3,103,30,118,3,51,0,Kolkata Knight Riders,0,7,1,1,0,1
528,2015,Kings XI Punjab,Delhi Daredevils,normal,166,169,90,40,1,129,60,69,2,100,30,120,2,49,0,Delhi Daredevils,0,5,1,1,1,1
529,2015,Sunrisers Hyderabad,Rajasthan Royals,normal,128,131,90,27,0,104,60,63,0,68,30,96,3,35,0,Rajasthan Royals,0,6,1,1,1,1
530,2015,Mumbai Indians,Chennai Super Kings,normal,184,189,90,72,0,117,60,128,2,61,30,168,4,21,0,Chennai Super Kings,0,6,1,1,1,1
531,2015,Delhi Daredevils,Sunrisers Hyderabad,normal,168,163,90,32,0,131,60,69,2,94,30,110,3,53,0,Delhi Daredevils,4,0,0,1,1,1
532,2015,Kings XI Punjab,Kolkata Knight Riders,normal,156,159,90,38,2,121,60,68,5,91,30,125,5,34,0,Kolkata Knight Riders,0,4,1,0,0,1
533,2015,Chennai Super Kings,Rajasthan Royals,normal,157,157,90,42,0,115,60,88,0,69,30,138,0,19,0,Rajasthan Royals,0,8,1,1,1,1
534,2015,Mumbai Indians,Royal Challengers Bangalore,normal,210,191,90,33,1,158,60,60,2,131,30,129,6,62,0,Mumbai Indians,18,0,0,0,0,0
535,2015,Delhi Daredevils,Kolkata Knight Riders,normal,147,147,90,35,2,112,60,79,3,68,30,119,3,28,0,Kolkata Knight Riders,0,6,1,0,1,1
536,2015,Rajasthan Royals,Kings XI Punjab,tie,192,191,90,33,1,158,60,67,3,124,30,120,4,71,0,Kings XI Punjab,0,0,1,0,0,0
538,2015,Chennai Super Kings,Royal Challengers Bangalore,normal,182,154,90,34,2,120,60,75,3,79,30,111,5,43,0,Chennai Super Kings,27,0,0,0,0,0
539,2015,Delhi Daredevils,Mumbai Indians,normal,191,153,90,38,1,115,60,81,3,72,30,120,4,33,0,Delhi Daredevils,37,0,0,1,0,0
540,2015,Rajasthan Royals,Royal Challengers Bangalore,normal,131,134,90,37,1,97,60,83,1,51,30,124,1,10,0,Royal Challengers Bangalore,0,9,1,1,1,1
541,2015,Mumbai Indians,Sunrisers Hyderabad,normal,158,137,90,45,1,92,60,74,3,63,30,104,4,33,0,Mumbai Indians,20,0,0,1,1,0
542,2015,Chennai Super Kings,Kings XI Punjab,normal,193,95,90,35,1,60,60,57,5,38,30,79,7,16,0,Chennai Super Kings,97,0,0,0,0,0
543,2015,Delhi Daredevils,Royal Challengers Bangalore,normal,96,99,90,43,0,56,60,90,0,9,30,99,0,0,0,Royal Challengers Bangalore,0,10,1,1,1,1
544,2015,Sunrisers Hyderabad,Kings XI Punjab,normal,151,130,90,21,2,109,60,61,4,69,30,93,5,37,0,Sunrisers Hyderabad,20,0,0,0,0,0
545,2015,Kolkata Knight Riders,Delhi Daredevils,normal,172,158,90,34,0,124,60,64,1,94,30,106,4,52,0,Kolkata Knight Riders,13,0,0,1,1,0
547,2015,Chennai Super Kings,Kolkata Knight Riders,normal,135,132,90,52,1,80,60,70,3,62,30,90,4,42,0,Chennai Super Kings,2,0,0,1,1,1
548,2015,Kings XI Punjab,Delhi Daredevils,normal,119,119,90,33,0,86,60,75,0,44,30,119,1,0,0,Delhi Daredevils,0,9,1,1,1,1
549,2015,Mumbai Indians,Rajasthan Royals,normal,188,179,90,49,1,130,60,87,2,92,30,127,3,52,0,Mumbai Indians,8,0,0,1,1,1
550,2015,Kolkata Knight Riders,Royal Challengers Bangalore,normal,112,115,90,52,2,63,60,115,3,0,30,115,3,0,0,Royal Challengers Bangalore,0,7,1,1,1,1
551,2015,Sunrisers Hyderabad,Chennai Super Kings,normal,193,170,90,48,1,122,60,87,3,83,30,130,5,40,0,Sunrisers Hyderabad,22,0,0,1,1,0
552,2015,Mumbai Indians,Kings XI Punjab,normal,173,149,90,42,2,107,60,73,2,76,30,113,3,36,0,Mumbai Indians,23,0,0,0,1,1
553,2015,Rajasthan Royals,Delhi Daredevils,normal,190,175,90,41,2,134,60,67,3,108,30,120,4,55,0,Rajasthan Royals,14,0,0,0,0,0
554,2015,Chennai Super Kings,Royal Challengers Bangalore,normal,149,124,90,34,2,90,60,71,3,53,30,100,5,24,0,Chennai Super Kings,24,0,0,0,1,0
555,2015,Kolkata Knight Riders,Sunrisers Hyderabad,normal,168,132,90,29,3,103,60,63,4,69,30,88,7,44,0,Kolkata Knight Riders,35,0,0,0,0,0
556,2015,Delhi Daredevils,Mumbai Indians,normal,153,153,90,36,3,117,60,61,4,92,30,99,4,54,0,Mumbai Indians,0,5,1,0,0,0
557,2015,Royal Challengers Bangalore,Kings XI Punjab,normal,227,88,90,29,3,59,60,63,8,25,30,88,10,0,0,Royal Challengers Bangalore,138,0,0,0,0,0
558,2015,Sunrisers Hyderabad,Rajasthan Royals,normal,202,194,90,35,2,159,60,68,3,126,30,126,5,68,0,Sunrisers Hyderabad,7,0,0,0,0,0
559,2015,Chennai Super Kings,Mumbai Indians,normal,159,159,90,50,0,109,60,84,0,75,30,101,3,58,0,Mumbai Indians,0,6,1,1,1,0
560,2015,Kings XI Punjab,Kolkata Knight Riders,normal,184,184,90,55,1,129,60,74,3,110,30,136,5,48,0,Kolkata Knight Riders,0,1,1,1,0,1
561,2015,Sunrisers Hyderabad,Delhi Daredevils,normal,164,157,90,34,1,123,60,65,3,92,30,104,4,53,0,Sunrisers Hyderabad,6,0,0,1,0,0
562,2015,Royal Challengers Bangalore,Mumbai Indians,normal,236,196,90,35,1,161,60,83,2,113,30,135,3,61,0,Royal Challengers Bangalore,39,0,0,0,0,0
563,2015,Chennai Super Kings,Rajasthan Royals,normal,158,145,90,32,0,113,60,63,3,82,30,93,5,52,0,Chennai Super Kings,12,0,0,1,0,0
564,2015,Sunrisers Hyderabad,Kings XI Punjab,normal,186,180,90,42,1,138,60,70,4,110,30,104,6,76,0,Sunrisers Hyderabad,5,0,0,1,0,0
565,2015,Chennai Super Kings,Delhi Daredevils,normal,120,120,90,24,2,96,60,66,2,54,30,97,3,23,0,Delhi Daredevils,0,6,1,0,1,1
567,2015,Mumbai Indians,Kolkata Knight Riders,normal,172,166,90,38,0,128,60,74,2,92,30,122,4,44,0,Mumbai Indians,5,0,0,1,1,1
569,2015,Kings XI Punjab,Chennai Super Kings,normal,131,134,90,40,2,94,60,76,2,58,30,111,3,23,0,Chennai Super Kings,0,7,1,1,1,1
570,2015,Rajasthan Royals,Kolkata Knight Riders,normal,200,190,90,44,2,146,60,97,3,93,30,144,5,46,0,Rajasthan Royals,9,0,0,0,1,1
572,2015,Sunrisers Hyderabad,Mumbai Indians,normal,114,114,90,37,0,77,60,73,0,41,30,114,1,0,0,Mumbai Indians,0,9,1,1,1,1
573,2015,Mumbai Indians,Chennai Super Kings,normal,188,162,90,46,1,116,60,86,2,76,30,121,6,41,0,Mumbai Indians,25,0,0,1,1,0
574,2015,Royal Challengers Bangalore,Rajasthan Royals,normal,181,109,90,34,2,75,60,68,3,41,30,92,7,17,0,Royal Challengers Bangalore,71,0,0,0,0,0
575,2015,Royal Challengers Bangalore,Chennai Super Kings,normal,140,140,90,28,1,112,60,62,3,78,30,91,3,49,0,Chennai Super Kings,0,3,1,1,1,1
576,2015,Mumbai Indians,Chennai Super Kings,normal,203,161,90,26,1,135,60,67,1,94,30,112,4,49,0,Mumbai Indians,41,0,0,0,0,0
577,2016,Mumbai Indians,Rising Pune Supergiants,normal,122,126,90,37,0,89,60,79,1,47,30,126,1,0,0,Rising Pune Supergiants,0,9,1,1,1,1
578,2016,Delhi Daredevils,Kolkata Knight Riders,normal,99,99,90,42,0,57,60,69,1,30,30,99,1,0,0,Kolkata Knight Riders,0,9,1,1,1,1
579,2016,Kings XI Punjab,Gujarat Lions,normal,162,162,90,45,1,117,60,98,2,64,30,134,4,28,0,Gujarat Lions,0,5,1,1,1,1
580,2016,Royal Challengers Bangalore,Sunrisers Hyderabad,normal,228,182,90,49,1,133,60,92,3,90,30,139,5,43,0,Royal Challengers Bangalore,45,0,0,1,0,0
581,2016,Kolkata Knight Riders,Mumbai Indians,normal,188,188,90,50,0,138,60,87,1,101,30,139,3,49,0,Mumbai Indians,0,6,1,1,1,1
582,2016,Rising Pune Supergiants,Gujarat Lions,normal,164,164,90,42,0,122,60,93,1,71,30,132,2,32,0,Gujarat Lions,0,7,1,1,1,1
583,2016,Kings XI Punjab,Delhi Daredevils,normal,112,113,90,20,1,93,60,68,1,45,30,113,2,0,0,Delhi Daredevils,0,8,1,0,1,1
584,2016,Sunrisers Hyderabad,Kolkata Knight Riders,normal,143,146,90,28,0,118,60,72,0,74,30,112,2,34,0,Kolkata Knight Riders,0,8,1,1,1,1
585,2016,Mumbai Indians,Gujarat Lions,normal,144,147,90,35,1,112,60,74,2,73,30,99,4,48,0,Gujarat Lions,0,3,1,1,1,1
586,2016,Rising Pune Supergiants,Kings XI Punjab,normal,153,153,90,43,0,110,60,71,0,82,30,112,3,41,0,Kings XI Punjab,0,6,1,1,1,1
587,2016,Royal Challengers Bangalore,Delhi Daredevils,normal,192,192,90,50,1,142,60,93,2,99,30,146,2,46,0,Delhi Daredevils,0,7,1,1,1,1
588,2016,Mumbai Indians,Sunrisers Hyderabad,normal,143,145,90,29,1,116,60,66,1,79,30,108,3,37,0,Sunrisers Hyderabad,0,7,1,1,1,1
589,2016,Kings XI Punjab,Kolkata Knight Riders,normal,139,141,90,55,0,86,60,93,1,48,30,117,3,24,0,Kolkata Knight Riders,0,6,1,1,1,1
590,2016,Royal Challengers Bangalore,Mumbai Indians,normal,171,171,90,43,1,128,60,81,1,90,30,128,3,43,0,Mumbai Indians,0,6,1,1,1,1
591,2016,Gujarat Lions,Sunrisers Hyderabad,normal,136,137,90,53,0,84,60,96,0,41,30,137,0,0,0,Sunrisers Hyderabad,0,10,1,1,1,1
592,2016,Royal Challengers Bangalore,Rising Pune Supergiants,normal,186,172,90,32,3,140,60,73,3,99,30,115,4,57,0,Royal Challengers Bangalore,13,0,0,0,0,0
593,2016,Delhi Daredevils,Mumbai Indians,normal,165,154,90,47,1,107,60,78,2,76,30,114,4,40,0,Delhi Daredevils,10,0,0,1,1,1
594,2016,Kings XI Punjab,Sunrisers Hyderabad,normal,144,146,90,58,0,88,60,90,2,56,30,119,3,27,0,Sunrisers Hyderabad,0,5,1,1,1,1
595,2016,Royal Challengers Bangalore,Gujarat Lions,normal,181,182,90,47,0,135,60,95,2,87,30,136,2,46,0,Gujarat Lions,0,6,1,1,1,1
596,2016,Rising Pune Supergiants,Kolkata Knight Riders,normal,161,162,90,49,2,113,60,78,3,84,30,114,4,48,0,Kolkata Knight Riders,0,2,1,1,1,1
597,2016,Mumbai Indians,Kings XI Punjab,normal,190,164,90,33,2,131,60,75,2,89,30,121,3,43,0,Mumbai Indians,25,0,0,0,1,0
599,2016,Gujarat Lions,Delhi Daredevils,normal,173,171,90,19,3,152,60,51,3,120,30,116,4,55,0,Gujarat Lions,1,0,0,0,0,1
600,2016,Kolkata Knight Riders,Mumbai Indians,normal,175,178,90,45,1,133,60,85,3,93,30,126,4,52,0,Mumbai Indians,0,6,1,1,1,1
601,2016,Rising Pune Supergiants,Gujarat Lions,normal,196,196,90,62,0,134,60,112,1,84,30,147,2,49,0,Gujarat Lions,0,3,1,1,1,1
602,2016,Delhi Daredevils,Kolkata Knight Riders,normal,187,159,90,33,2,126,60,88,3,71,30,127,5,32,0,Delhi Daredevils,27,0,0,0,1,0
603,2016,Sunrisers Hyderabad,Royal Challengers Bangalore,normal,195,179,90,42,0,137,60,83,2,96,30,132,4,47,0,Sunrisers Hyderabad,15,0,0,1,1,1
604,2016,Kings XI Punjab,Gujarat Lions,normal,155,131,90,34,2,97,60,57,5,74,30,87,7,44,0,Kings XI Punjab,23,0,0,0,0,0
605,2016,Rising Pune Supergiants,Mumbai Indians,normal,160,161,90,43,1,118,60,76,1,85,30,115,2,46,0,Mumbai Indians,0,8,1,1,1,1
606,2016,Royal Challengers Bangalore,Kolkata Knight Riders,normal,186,189,90,34,2,155,60,69,3,120,30,123,4,66,0,Kolkata Knight Riders,0,5,1,0,0,0
607,2016,Gujarat Lions,Delhi Daredevils,normal,150,150,90,51,0,99,60,93,0,57,30,121,2,29,0,Delhi Daredevils,0,8,1,1,1,1
608,2016,Kolkata Knight Riders,Kings XI Punjab,normal,165,157,90,27,3,130,60,64,4,93,30,117,4,40,0,Kolkata Knight Riders,7,0,0,0,0,1
609,2016,Delhi Daredevils,Rising Pune Supergiants,normal,163,166,90,38,0,128,60,74,1,92,30,116,2,50,0,Rising Pune Supergiants,0,7,1,1,1,1
610,2016,Gujarat Lions,Sunrisers Hyderabad,normal,127,129,90,33,2,96,60,57,3,72,30,91,4,38,0,Sunrisers Hyderabad,0,5,1,1,1,1
611,2016,Rising Pune Supergiants,Royal Challengers Bangalore,normal,192,195,90,37,0,158,60,81,0,114,30,142,2,53,0,Royal Challengers Bangalore,0,7,1,1,1,1
612,2016,Kings XI Punjab,Delhi Daredevils,normal,182,172,90,35,0,137,60,91,1,81,30,132,2,40,0,Kings XI Punjab,9,0,0,1,1,1
613,2016,Sunrisers Hyderabad,Mumbai Indians,normal,178,92,90,31,5,61,60,54,7,38,30,85,9,7,0,Sunrisers Hyderabad,85,0,0,0,0,0
614,2016,Kolkata Knight Riders,Gujarat Lions,normal,159,164,90,36,0,128,60,89,2,75,30,135,3,29,0,Gujarat Lions,0,5,1,1,1,1
615,2016,Royal Challengers Bangalore,Kings XI Punjab,normal,176,174,90,43,0,131,60,83,1,91,30,123,3,51,0,Royal Challengers Bangalore,1,0,0,1,1,1
616,2016,Sunrisers Hyderabad,Rising Pune Supergiants,normal,138,133,90,20,2,113,60,52,2,81,30,86,5,47,0,Sunrisers Hyderabad,4,0,0,0,0,0
617,2016,Royal Challengers Bangalore,Mumbai Indians,normal,152,153,90,30,1,123,60,60,2,93,30,97,3,56,0,Mumbai Indians,0,6,1,1,1,0
618,2016,Sunrisers Hyderabad,Delhi Daredevils,normal,147,150,90,41,1,109,60,78,3,72,30,114,3,36,0,Delhi Daredevils,0,7,1,1,1,1
619,2016,Mumbai Indians,Kings XI Punjab,normal,125,127,90,26,1,101,60,61,1,66,30,110,1,17,0,Kings XI Punjab,0,7,1,1,1,1
620,2016,Royal Challengers Bangalore,Gujarat Lions,normal,249,104,90,37,2,67,60,54,5,50,30,94,8,10,0,Royal Challengers Bangalore,144,0,0,0,0,0
622,2016,Kings XI Punjab,Sunrisers Hyderabad,normal,180,180,90,44,0,136,60,78,1,102,30,130,2,50,0,Sunrisers Hyderabad,0,7,1,1,1,1
623,2016,Mumbai Indians,Delhi Daredevils,normal,207,126,90,47,2,79,60,81,4,45,30,108,6,18,0,Mumbai Indians,80,0,0,0,0,0
624,2016,Kolkata Knight Riders,Royal Challengers Bangalore,normal,184,186,90,53,0,133,60,91,1,95,30,135,1,51,0,Royal Challengers Bangalore,0,9,1,1,1,1
627,2016,Kolkata Knight Riders,Gujarat Lions,normal,125,125,90,45,3,80,60,97,4,28,30,125,4,0,0,Gujarat Lions,0,6,1,1,1,1
628,2016,Sunrisers Hyderabad,Delhi Daredevils,normal,159,161,90,36,1,125,60,68,1,93,30,107,2,54,0,Delhi Daredevils,0,6,1,1,1,1
629,2016,Kings XI Punjab,Rising Pune Supergiants,normal,173,173,90,35,1,138,60,62,2,111,30,103,5,70,0,Rising Pune Supergiants,0,4,1,1,0,0
630,2016,Mumbai Indians,Gujarat Lions,normal,173,173,90,51,1,122,60,100,2,73,30,147,4,26,0,Gujarat Lions,0,6,1,1,1,1
631,2016,Kolkata Knight Riders,Sunrisers Hyderabad,normal,172,149,90,39,1,110,60,73,1,76,30,114,4,35,0,Kolkata Knight Riders,22,0,0,1,1,0
632,2016,Delhi Daredevils,Royal Challengers Bangalore,normal,139,139,90,38,2,101,60,83,2,56,30,111,4,28,0,Royal Challengers Bangalore,0,6,1,1,1,1
633,2016,Gujarat Lions,Royal Challengers Bangalore,normal,159,159,90,28,4,131,60,70,6,89,30,110,6,49,0,Royal Challengers Bangalore,0,4,1,0,0,0
634,2016,Sunrisers Hyderabad,Kolkata Knight Riders,normal,163,140,90,43,1,97,60,66,3,74,30,110,4,30,0,Sunrisers Hyderabad,22,0,0,1,0,1
635,2016,Gujarat Lions,Sunrisers Hyderabad,normal,163,163,90,43,2,120,60,66,3,97,30,116,5,47,0,Sunrisers Hyderabad,0,4,1,1,0,1
636,2016,Sunrisers Hyderabad,Royal Challengers Bangalore,normal,209,200,90,55,0,145,60,112,0,88,30,158,3,42,0,Sunrisers Hyderabad,8,0,0,1,1,1
7894,2018,Mumbai Indians,Chennai Super Kings,normal,170,176,90,39,1,137,60,58,4,118,30,111,7,65,0,Chennai Super Kings,0,1,1,1,0,0
7895,2018,Delhi Daredevils,Kings XI Punjab,normal,173,168,90,64,2,104,60,99,3,69,30,132,3,36,0,Kings XI Punjab,0,6,1,1,1,1
7896,2018,Royal Challengers Bangalore,Kolkata Knight Riders,normal,183,190,90,66,1,124,60,103,3,87,30,150,4,40,0,Kolkata Knight Riders,0,4,1,1,1,1
7897,2018,Rajasthan Royals,Sunrisers Hyderabad,normal,134,135,90,47,1,88,60,93,1,42,30,131,1,4,0,Sunrisers Hyderabad,0,9,1,1,1,1
7898,2018,Kolkata Knight Riders,Chennai Super Kings,normal,208,212,90,63,0,149,60,90,2,122,30,148,3,64,0,Chennai Super Kings,0,5,1,1,1,1
7900,2018,Mumbai Indians,Sunrisers Hyderabad,normal,156,155,90,43,0,112,60,90,3,65,30,124,5,31,0,Sunrisers Hyderabad,0,1,1,1,1,1
7901,2018,Kings XI Punjab,Royal Challengers Bangalore,normal,162,163,90,34,2,129,60,81,2,82,30,112,4,51,0,Royal Challengers Bangalore,0,4,1,0,1,1
7902,2018,Mumbai Indians,Delhi Daredevils,normal,205,197,90,50,0,147,60,104,1,93,30,149,3,48,0,Delhi Daredevils,0,7,1,1,1,1
7903,2018,Kolkata Knight Riders,Sunrisers Hyderabad,normal,146,144,90,48,1,96,60,66,3,78,30,116,3,28,0,Sunrisers Hyderabad,0,5,1,1,1,1
7904,2018,Rajasthan Royals,Royal Challengers Bangalore,normal,232,204,90,49,1,155,60,103,2,101,30,138,5,66,0,Rajasthan Royals,19,0,0,1,1,0
7905,2018,Kings XI Punjab,Chennai Super Kings,normal,199,206,90,51,2,155,60,93,3,113,30,131,4,75,0,Kings XI Punjab,4,0,0,1,1,0
7906,2018,Kolkata Knight Riders,Delhi Daredevils,normal,207,136,90,51,3,85,60,106,5,30,30,136,10,0,0,Kolkata Knight Riders,71,0,0,0,0,0
7907,2018,Mumbai Indians,Royal Challengers Bangalore,normal,231,173,90,46,2,127,60,80,3,93,30,113,5,60,0,Mumbai Indians,46,0,0,0,0,0
7908,2018,Rajasthan Royals,Kolkata Knight Riders,normal,166,166,90,40,1,126,60,89,2,77,30,123,3,43,0,Kolkata Knight Riders,0,7,1,1,1,1
7909,2018,Kings XI Punjab,Sunrisers Hyderabad,normal,202,191,90,39,3,152,60,76,3,115,30,125,4,66,0,Kings XI Punjab,15,0,0,0,0,0
7910,2018,Chennai Super Kings,Rajasthan Royals,normal,211,148,90,36,3,112,60,82,3,66,30,123,7,25,0,Chennai Super Kings,64,0,0,0,0,0
7912,2018,Delhi Daredevils,Royal Challengers Bangalore,normal,187,180,90,38,2,142,60,84,2,96,30,143,3,37,0,Royal Challengers Bangalore,0,6,1,0,1,1
7913,2018,Chennai Super Kings,Sunrisers Hyderabad,normal,187,180,90,29,3,151,60,72,3,108,30,119,4,61,0,Chennai Super Kings,4,0,0,0,0,0
7914,2018,Mumbai Indians,Rajasthan Royals,normal,173,174,90,37,1,137,60,72,2,102,30,122,3,52,0,Rajasthan Royals,0,3,1,1,1,1
7915,2018,Kings XI Punjab,Delhi Daredevils,normal,158,148,90,46,2,102,60,69,4,79,30,103,5,45,0,Kings XI Punjab,4,0,0,1,0,0
7916,2018,Sunrisers Hyderabad,Mumbai Indians,normal,131,89,90,21,2,68,60,53,3,36,30,78,6,11,0,Sunrisers Hyderabad,31,0,0,0,0,0
7917,2018,Royal Challengers Bangalore,Chennai Super Kings,normal,214,218,90,51,1,167,60,85,4,133,30,141,4,77,0,Chennai Super Kings,0,5,1,1,0,0
7918,2018,Sunrisers Hyderabad,Kings XI Punjab,normal,141,121,90,35,0,86,60,67,2,54,30,91,5,30,0,Sunrisers Hyderabad,13,0,0,1,1,0
7919,2018,Delhi Daredevils,Kolkata Knight Riders,normal,224,168,90,46,3,122,60,83,5,85,30,142,5,26,0,Delhi Daredevils,55,0,0,0,0,0
7920,2018,Chennai Super Kings,Mumbai Indians,normal,177,180,90,43,0,137,60,77,1,103,30,132,1,48,0,Mumbai Indians,0,8,1,1,1,1
7921,2018,Sunrisers Hyderabad,Rajasthan Royals,normal,153,141,90,35,1,106,60,73,2,68,30,103,4,38,0,Sunrisers Hyderabad,11,0,0,1,1,1
7922,2018,Royal Challengers Bangalore,Kolkata Knight Riders,normal,186,184,90,49,0,135,60,92,1,92,30,129,2,55,0,Kolkata Knight Riders,0,6,1,1,1,1
7923,2018,Chennai Super Kings,Delhi Daredevils,normal,219,206,90,47,2,159,60,80,4,126,30,132,4,74,0,Chennai Super Kings,13,0,0,0,0,0
7924,2018,Royal Challengers Bangalore,Mumbai Indians,normal,174,176,90,35,3,141,60,91,4,85,30,128,5,48,0,Royal Challengers Bangalore,14,0,0,0,1,1
7926,2018,Chennai Super Kings,Kolkata Knight Riders,normal,185,192,90,46,2,146,60,97,3,95,30,151,4,41,0,Kolkata Knight Riders,0,6,1,0,1,1
7927,2018,Kings XI Punjab,Mumbai Indians,normal,185,182,90,37,0,145,60,68,1,114,30,119,3,63,0,Mumbai Indians,0,6,1,1,1,1
7928,2018,Royal Challengers Bangalore,Chennai Super Kings,normal,132,135,90,27,1,108,60,72,2,63,30,93,4,42,0,Chennai Super Kings,0,6,1,1,1,1
7929,2018,Delhi Daredevils,Sunrisers Hyderabad,normal,167,170,90,36,0,134,60,85,1,85,30,120,2,50,0,Sunrisers Hyderabad,0,7,1,1,1,1
7930,2018,Mumbai Indians,Kolkata Knight Riders,normal,188,177,90,48,2,129,60,96,2,81,30,127,4,50,0,Mumbai Indians,13,0,0,1,1,1
7931,2018,Rajasthan Royals,Kings XI Punjab,normal,161,158,90,35,2,123,60,70,2,88,30,105,4,53,0,Kings XI Punjab,0,6,1,0,1,0
7932,2018,Sunrisers Hyderabad,Royal Challengers Bangalore,normal,156,146,90,48,1,98,60,77,3,69,30,104,5,42,0,Sunrisers Hyderabad,5,0,0,1,1,0
7933,2018,Rajasthan Royals,Kings XI Punjab,normal,162,149,90,25,2,124,60,55,3,94,30,97,5,52,0,Rajasthan Royals,15,0,0,0,0,0
7934,2018,Mumbai Indians,Kolkata Knight Riders,normal,218,109,90,39,2,70,60,72,6,37,30,95,8,14,0,Mumbai Indians,102,0,0,0,0,0
7935,2018,Delhi Daredevils,Sunrisers Hyderabad,normal,191,193,90,39,1,154,60,93,1,100,30,154,1,39,0,Sunrisers Hyderabad,0,9,1,1,1,1
7936,2018,Chennai Super Kings,Rajasthan Royals,normal,189,180,90,55,2,125,60,90,2,90,30,124,4,56,0,Rajasthan Royals,0,4,1,1,1,0
7937,2018,Kolkata Knight Riders,Kings XI Punjab,normal,251,221,90,52,0,169,60,103,4,118,30,153,5,68,0,Kolkata Knight Riders,31,0,0,1,0,0
7938,2018,Delhi Daredevils,Royal Challengers Bangalore,normal,189,198,90,50,2,148,60,101,2,97,30,153,3,45,0,Royal Challengers Bangalore,0,5,1,1,1,1
7939,2018,Sunrisers Hyderabad,Chennai Super Kings,normal,193,181,90,43,0,138,60,93,0,88,30,144,2,37,0,Chennai Super Kings,0,8,1,1,1,1
7940,2018,Mumbai Indians,Rajasthan Royals,normal,178,181,90,52,1,129,60,91,1,90,30,140,2,41,0,Rajasthan Royals,0,7,1,1,1,1
7941,2018,Kings XI Punjab,Royal Challengers Bangalore,normal,94,96,90,56,0,40,60,96,0,0,30,96,0,0,0,Royal Challengers Bangalore,0,10,1,1,1,1
7942,2018,Rajasthan Royals,Kolkata Knight Riders,normal,145,147,90,46,2,101,60,81,3,66,30,117,3,30,0,Kolkata Knight Riders,0,6,1,1,1,1
7943,2018,Mumbai Indians,Kings XI Punjab,normal,198,192,90,47,1,145,60,88,1,104,30,132,1,60,0,Mumbai Indians,3,0,0,1,1,1
7944,2018,Royal Challengers Bangalore,Sunrisers Hyderabad,normal,223,209,90,47,0,162,60,91,2,118,30,152,2,57,0,Royal Challengers Bangalore,14,0,0,1,1,1
7945,2018,Delhi Daredevils,Chennai Super Kings,normal,172,130,90,23,0,107,60,71,2,59,30,95,4,35,0,Delhi Daredevils,34,0,0,0,1,0
7946,2018,Rajasthan Royals,Royal Challengers Bangalore,normal,175,137,90,46,1,91,60,85,3,52,30,109,6,28,0,Rajasthan Royals,30,0,0,1,1,0
7947,2018,Sunrisers Hyderabad,Kolkata Knight Riders,normal,184,180,90,64,1,116,60,94,1,86,30,136,2,44,0,Kolkata Knight Riders,0,5,1,1,1,1
7948,2018,Delhi Daredevils,Mumbai Indians,normal,187,170,90,50,1,120,60,82,5,88,30,127,7,43,0,Delhi Daredevils,11,0,0,1,0,0
7949,2018,Kings XI Punjab,Chennai Super Kings,normal,165,168,90,29,3,139,60,64,3,104,30,110,4,58,0,Chennai Super Kings,0,5,1,0,0,1
7950,2018,Sunrisers Hyderabad,Chennai Super Kings,normal,149,145,90,26,3,119,60,53,4,92,30,95,7,50,0,Chennai Super Kings,0,2,1,0,0,0
7951,2018,Kolkata Knight Riders,Rajasthan Royals,normal,180,145,90,48,0,97,60,88,1,57,30,112,2,33,0,Kolkata Knight Riders,25,0,0,1,1,0
7952,2018,Sunrisers Hyderabad,Kolkata Knight Riders,normal,180,163,90,60,1,103,60,95,2,68,30,120,6,43,0,Sunrisers Hyderabad,14,0,0,1,1,0
7953,2018,Sunrisers Hyderabad,Chennai Super Kings,normal,187,187,90,21,1,166,60,83,1,104,30,151,2,36,0,Chennai Super Kings,0,8,1,0,1,1
11137,2019,Royal Challengers Bangalore,Chennai Super Kings,normal,75,76,90,15,1,61,60,44,2,32,30,66,3,10,0,Chennai Super Kings,0,7,1,1,1,1
11138,2019,Sunrisers Hyderabad,Kolkata Knight Riders,normal,190,187,90,40,1,147,60,71,1,116,30,117,3,70,0,Kolkata Knight Riders,0,6,1,1,1,0
11139,2019,Delhi Capitals,Mumbai Indians,normal,220,185,90,39,1,146,60,92,3,93,30,139,6,46,0,Delhi Capitals,37,0,0,0,0,0
11140,2019,Kings XI Punjab,Rajasthan Royals,normal,201,175,90,45,0,130,60,96,1,79,30,139,2,36,0,Kings XI Punjab,14,0,0,1,1,1
11141,2019,Delhi Capitals,Chennai Super Kings,normal,155,157,90,55,1,102,60,101,1,56,30,126,2,31,0,Chennai Super Kings,0,6,1,1,1,1
11142,2019,Kolkata Knight Riders,Kings XI Punjab,normal,224,196,90,45,2,151,60,80,3,116,30,138,3,58,0,Kolkata Knight Riders,28,0,0,0,0,0
11143,2019,Mumbai Indians,Royal Challengers Bangalore,normal,198,186,90,48,1,138,60,82,2,104,30,129,3,57,0,Mumbai Indians,6,0,0,1,1,1
11144,2019,Rajasthan Royals,Sunrisers Hyderabad,normal,204,211,90,55,0,156,60,121,1,90,30,172,3,39,0,Sunrisers Hyderabad,0,5,1,1,1,1
11145,2019,Mumbai Indians,Kings XI Punjab,normal,188,185,90,36,0,149,60,88,1,97,30,146,2,39,0,Kings XI Punjab,0,8,1,1,1,1
11146,2019,Kolkata Knight Riders,Delhi Capitals,tie,194,189,90,34,1,155,60,84,1,105,30,143,2,46,0,Delhi Capitals,0,0,1,0,1,1
11147,2019,Sunrisers Hyderabad,Royal Challengers Bangalore,normal,234,120,90,24,3,96,60,49,6,71,30,91,6,29,0,Sunrisers Hyderabad,118,0,0,0,0,0
11148,2019,Chennai Super Kings,Rajasthan Royals,normal,183,174,90,30,3,144,60,78,4,96,30,116,5,58,0,Chennai Super Kings,8,0,0,0,0,0
11149,2019,Kings XI Punjab,Delhi Capitals,normal,176,163,90,44,1,119,60,93,3,70,30,138,3,25,0,Kings XI Punjab,14,0,0,1,1,1
11150,2019,Royal Challengers Bangalore,Rajasthan Royals,normal,165,174,90,52,0,122,60,87,1,87,30,129,2,45,0,Rajasthan Royals,0,7,1,1,1,1
11151,2019,Mumbai Indians,Chennai Super Kings,normal,177,147,90,35,3,112,60,71,3,76,30,107,5,40,0,Mumbai Indians,37,0,0,0,0,0
11152,2019,Delhi Capitals,Sunrisers Hyderabad,normal,135,142,90,57,0,85,60,90,2,52,30,114,4,28,0,Sunrisers Hyderabad,0,5,1,1,1,1
11153,2019,Royal Challengers Bangalore,Kolkata Knight Riders,normal,211,219,90,58,1,161,60,102,2,117,30,142,3,77,0,Kolkata Knight Riders,0,5,1,1,1,1
11309,2019,Chennai Super Kings,Kings XI Punjab,normal,166,142,90,36,2,106,60,72,2,70,30,107,2,35,0,Chennai Super Kings,22,0,0,0,1,1
11310,2019,Mumbai Indians,Sunrisers Hyderabad,normal,143,102,90,35,2,67,60,61,3,41,30,86,5,16,0,Mumbai Indians,40,0,0,0,0,0
11311,2019,Royal Challengers Bangalore,Delhi Capitals,normal,155,164,90,54,1,110,60,88,2,76,30,134,3,30,0,Delhi Capitals,0,4,1,1,1,1
11312,2019,Rajasthan Royals,Kolkata Knight Riders,normal,151,151,90,55,0,96,60,111,1,40,30,151,2,0,0,Kolkata Knight Riders,0,8,1,1,1,1
11313,2019,Sunrisers Hyderabad,Kings XI Punjab,normal,159,152,90,30,1,122,60,69,1,83,30,112,1,40,0,Kings XI Punjab,0,6,1,0,1,1
11314,2019,Kolkata Knight Riders,Chennai Super Kings,normal,115,119,90,36,2,83,60,59,2,60,30,87,3,32,0,Chennai Super Kings,0,7,1,1,1,1
11315,2019,Kings XI Punjab,Mumbai Indians,normal,205,210,90,41,1,169,60,66,3,144,30,143,4,67,0,Mumbai Indians,0,3,1,1,0,1
11316,2019,Rajasthan Royals,Chennai Super Kings,normal,159,164,90,24,3,140,60,50,4,114,30,103,4,61,0,Chennai Super Kings,0,4,1,0,0,0
11317,2019,Kolkata Knight Riders,Delhi Capitals,normal,184,183,90,55,1,128,60,88,2,95,30,141,2,42,0,Delhi Capitals,0,7,1,1,1,1
11318,2019,Mumbai Indians,Rajasthan Royals,normal,192,192,90,50,0,142,60,103,1,89,30,161,2,31,0,Rajasthan Royals,0,4,1,1,1,1
11319,2019,Kings XI Punjab,Royal Challengers Bangalore,normal,181,175,90,54,1,121,60,88,1,87,30,127,1,48,0,Royal Challengers Bangalore,0,8,1,1,1,1
11320,2019,Kolkata Knight Riders,Chennai Super Kings,normal,171,164,90,44,1,120,60,71,3,93,30,121,4,43,0,Chennai Super Kings,0,5,1,1,0,1
11321,2019,Delhi Capitals,Sunrisers Hyderabad,normal,165,121,90,37,0,84,60,75,1,46,30,103,2,18,0,Delhi Capitals,39,0,0,1,1,0
11322,2019,Royal Challengers Bangalore,Mumbai Indians,normal,180,179,90,56,0,123,60,100,2,79,30,131,3,48,0,Mumbai Indians,0,5,1,1,1,1
11323,2019,Kings XI Punjab,Rajasthan Royals,normal,191,180,90,59,1,121,60,97,1,83,30,130,2,50,0,Kings XI Punjab,12,0,0,1,1,1
11324,2019,Chennai Super Kings,Sunrisers Hyderabad,normal,140,140,90,59,0,81,60,86,2,54,30,117,3,23,0,Sunrisers Hyderabad,0,6,1,1,1,1
11325,2019,Mumbai Indians,Delhi Capitals,normal,175,136,90,42,0,94,60,64,3,72,30,88,5,48,0,Mumbai Indians,40,0,0,1,0,0
11326,2019,Royal Challengers Bangalore,Kolkata Knight Riders,normal,220,219,90,37,3,182,60,69,3,150,30,134,4,85,0,Royal Challengers Bangalore,10,0,0,0,0,0
11327,2019,Mumbai Indians,Rajasthan Royals,normal,172,168,90,53,1,115,60,95,3,73,30,134,3,34,0,Rajasthan Royals,0,5,1,1,1,1
11328,2019,Kings XI Punjab,Delhi Capitals,normal,169,177,90,52,1,125,60,95,1,82,30,137,2,40,0,Delhi Capitals,0,5,1,1,1,1
11329,2019,Kolkata Knight Riders,Sunrisers Hyderabad,normal,165,167,90,55,0,112,60,114,0,53,30,167,1,0,0,Sunrisers Hyderabad,0,9,1,1,1,1
11330,2019,Royal Challengers Bangalore,Chennai Super Kings,normal,166,172,90,29,3,143,60,66,4,106,30,103,5,69,0,Royal Challengers Bangalore,1,0,0,0,0,0
11331,2019,Rajasthan Royals,Delhi Capitals,normal,197,194,90,45,0,149,60,81,2,113,30,142,2,52,0,Delhi Capitals,0,6,1,1,1,1
11332,2019,Sunrisers Hyderabad,Chennai Super Kings,normal,180,185,90,27,1,158,60,86,2,99,30,142,2,43,0,Chennai Super Kings,0,6,1,0,1,1
11333,2019,Royal Challengers Bangalore,Kings XI Punjab,normal,214,190,90,59,1,131,60,108,2,82,30,147,3,43,0,Royal Challengers Bangalore,17,0,0,1,1,1
11334,2019,Kolkata Knight Riders,Rajasthan Royals,normal,186,182,90,53,0,129,60,79,3,103,30,126,5,56,0,Rajasthan Royals,0,3,1,1,0,0
11335,2019,Mumbai Indians,Chennai Super Kings,normal,160,116,90,35,3,81,60,63,5,53,30,94,6,22,0,Mumbai Indians,46,0,0,0,0,0
11336,2019,Sunrisers Hyderabad,Rajasthan Royals,normal,170,167,90,41,0,126,60,80,1,87,30,135,2,32,0,Rajasthan Royals,0,7,1,1,1,1
11337,2019,Delhi Capitals,Royal Challengers Bangalore,normal,194,176,90,57,0,119,60,92,2,84,30,129,5,47,0,Delhi Capitals,16,0,0,1,1,0
11338,2019,Kolkata Knight Riders,Mumbai Indians,normal,242,204,90,30,2,174,60,80,4,124,30,142,5,62,0,Kolkata Knight Riders,34,0,0,0,0,0
11339,2019,Sunrisers Hyderabad,Kings XI Punjab,normal,233,174,90,43,1,131,60,86,2,88,30,128,5,46,0,Sunrisers Hyderabad,45,0,0,0,0,0
11341,2019,Chennai Super Kings,Delhi Capitals,normal,187,99,90,49,1,50,60,80,4,19,30,92,8,7,0,Chennai Super Kings,80,0,0,1,0,0
11342,2019,Mumbai Indians,Sunrisers Hyderabad,tie,171,165,90,58,1,107,60,82,3,83,30,108,5,57,0,Mumbai Indians,0,0,0,1,1,0
11343,2019,Kings XI Punjab,Kolkata Knight Riders,normal,187,192,90,48,0,144,60,99,1,93,30,157,3,35,0,Kolkata Knight Riders,0,7,1,1,1,1
11344,2019,Rajasthan Royals,Delhi Capitals,normal,125,126,90,33,2,93,60,74,3,52,30,105,4,21,0,Delhi Capitals,0,5,1,1,1,1
11345,2019,Sunrisers Hyderabad,Royal Challengers Bangalore,normal,180,187,90,49,3,138,60,81,3,106,30,135,3,52,0,Royal Challengers Bangalore,0,4,1,0,1,1
11346,2019,Chennai Super Kings,Kings XI Punjab,normal,173,188,90,61,0,127,60,115,0,73,30,161,3,27,0,Kings XI Punjab,0,6,1,1,1,1
11347,2019,Kolkata Knight Riders,Mumbai Indians,normal,144,137,90,47,0,90,60,78,1,59,30,124,1,13,0,Mumbai Indians,0,9,1,1,1,1
11412,2019,Chennai Super Kings,Mumbai Indians,normal,137,140,90,36,2,104,60,72,2,68,30,116,4,24,0,Mumbai Indians,0,6,1,1,1,1
11413,2019,Sunrisers Hyderabad,Delhi Capitals,normal,172,170,90,50,0,120,60,86,0,84,30,114,4,56,0,Delhi Capitals,0,2,1,1,1,0
11414,2019,Delhi Capitals,Chennai Super Kings,normal,156,162,90,27,0,135,60,86,0,76,30,125,2,37,0,Chennai Super Kings,0,6,1,1,1,1
11415,2019,Mumbai Indians,Chennai Super Kings,normal,150,148,90,38,1,0,60,75,2,0,30,92,4,0,0,Mumbai Indians,1,0,0,1,1,0
